Item Code,Description,Item Category,Oraganization,Sub Inventory,To Location,To Subinventory,Document Number,Transaction ID,Transaction DATE,SellingÂ  Price,Value of Selling Price,Lot Number,UOM,Transaction Type,Transaction Quantity,Transaction Cost,Transaction Value,Balance Quantity,Balance Value
6020040013,XYLOCAINE-2% INJECTION -1'S,Medicine,Rayan Hospital,RYN_IP,,,,1111610264,02-01-2024,8.4,-8.4,681193.0,VL,Issue to Patient,1.0,5.77687,-5.77687,339.0,1958.35796
6020040013,XYLOCAINE-2% INJECTION -1'S,Medicine,Rayan Hospital,RAY_ENT,RYN 11205-E.N.T. (Otolaryngology),,15437037,1112939459,04-01-2024,8.4,-8.4,681187.0,VL,Move Order Issue,1.0,5.77687,-5.77687,338.0,1952.5811
6020040013,XYLOCAINE-2% INJECTION -1'S,Medicine,Rayan Hospital,RAY_OBGY1F,RYN 11215-OB&Gyne,,15443780,1113766876,06-01-2024,8.4,-100.8,681192.0,VL,Move Order Issue,12.0,5.77687,-69.32241,327.0,1889.03556
6020040013,XYLOCAINE-2% INJECTION -1'S,Medicine,Rayan Hospital,RAY_OBGY1F,RYN 11215-OB&Gyne,,15443780,1113766876,06-01-2024,8.4,-25.2,681193.0,VL,Move Order Issue,3.0,5.77687,-17.3306,324.0,1871.70496
6020040013,XYLOCAINE-2% INJECTION -1'S,Medicine,Rayan Hospital,RAY_OPTHA,RYN 11216-Ophthalmology,,15444485,1113773654,06-01-2024,8.4,-8.4,681192.0,VL,Move Order Issue,1.0,5.77687,-5.77687,323.0,1865.92809
6020040013,XYLOCAINE-2% INJECTION -1'S,Medicine,Rayan Hospital,RAY_OBGY2F,RYN 11215-OB&Gyne,,15443817,1113780344,06-01-2024,8.4,-100.8,681192.0,VL,Move Order Issue,12.0,5.77687,-69.32241,311.0,1796.60568
6020040013,XYLOCAINE-2% INJECTION -1'S,Medicine,Rayan Hospital,STAGE,Rayan Hospital Clinics,RAY_LDR,17452405,1114034442,07-01-2024,8.4,-168.0,681192.0,VL,Int Order Direct Ship,20.0,5.77687,-115.53734,291.0,1681.06834
6020040013,XYLOCAINE-2% INJECTION -1'S,Medicine,Rayan Hospital,STAGE,Rayan Hospital Clinics,RAY_CATHLB,17450964,1114041977,07-01-2024,8.4,-25.2,681192.0,VL,Int Order Direct Ship,3.0,5.77687,-17.3306,578.0,3339.02891
6020040013,XYLOCAINE-2% INJECTION -1'S,Medicine,Rayan Hospital,RYN_IP,,,,1114439713,08-01-2024,8.4,-8.4,681195.0,VL,Issue to Patient,1.0,5.77687,-5.77687,577.0,3333.25204
6020040013,XYLOCAINE-2% INJECTION -1'S,Medicine,Rayan Hospital,STAGE,Rayan Hospital Clinics,RAY_TELMET,17451529,1114815605,08-01-2024,8.4,-8.4,681193.0,VL,Int Order Direct Ship,1.0,5.77687,-5.77687,576.0,3327.47518
6020040013,XYLOCAINE-2% INJECTION -1'S,Medicine,Rayan Hospital,STAGE,Rayan Hospital Clinics,RAY_ER,17451407,1114825246,08-01-2024,8.4,-25.2,681193.0,VL,Int Order Direct Ship,3.0,5.77687,-17.3306,573.0,3310.14458
6020040013,XYLOCAINE-2% INJECTION -1'S,Medicine,Rayan Hospital,RAY_NEURO,RYN 11214-Neurology,,15450644,1114911260,08-01-2024,8.4,-8.4,681192.0,VL,Move Order Issue,1.0,5.77687,-5.77687,572.0,3304.36771
6020040013,XYLOCAINE-2% INJECTION -1'S,Medicine,Rayan Hospital,RAY_DERMA,RYN 11204-Dermatology,,15453717,1115759739,10-01-2024,8.4,-33.6,681192.0,VL,Move Order Issue,4.0,5.77687,-23.10747,568.0,3281.26024
6020040013,XYLOCAINE-2% INJECTION -1'S,Medicine,Rayan Hospital,RAY_DERMA,RYN 11204-Dermatology,,15453717,1115759739,10-01-2024,8.4,-25.2,681193.0,VL,Move Order Issue,3.0,5.77687,-17.3306,565.0,3263.92964
6020040013,XYLOCAINE-2% INJECTION -1'S,Medicine,Rayan Hospital,STAGE,Rayan Hospital Clinics,RAY_LDR,17453516,1115802697,10-01-2024,8.4,-168.0,681193.0,VL,Int Order Direct Ship,20.0,5.77687,-115.53733,545.0,3148.39231
6020040013,XYLOCAINE-2% INJECTION -1'S,Medicine,Rayan Hospital,STAGE,Rayan Hospital Clinics,RAY_ICUB,17454337,1116337726,11-01-2024,8.4,-8.4,681193.0,VL,Int Order Direct Ship,1.0,5.77687,-5.77687,544.0,3142.61544
6020040013,XYLOCAINE-2% INJECTION -1'S,Medicine,Rayan Hospital,RAY_UROLGY,RYN 11225-Urology,,15450186,1116416097,11-01-2024,8.4,-16.8,681192.0,VL,Move Order Issue,2.0,5.77687,-11.55373,542.0,3131.06171
6020040013,XYLOCAINE-2% INJECTION -1'S,Medicine,Rayan Hospital,STAGE,Rayan Hospital Clinics,RAY_LDR,17455213,1117503162,14-01-2024,8.4,-126.0,681194.0,VL,Int Order Direct Ship,15.0,5.77687,-86.653,527.0,3044.40871
6020040013,XYLOCAINE-2% INJECTION -1'S,Medicine,Rayan Hospital,STAGE,Rayan Hospital Clinics,RAY_LDR,17455213,1117503164,14-01-2024,8.4,-42.0,681193.0,VL,Int Order Direct Ship,5.0,5.77687,-28.88433,522.0,3015.52438
6020040013,XYLOCAINE-2% INJECTION -1'S,Medicine,Rayan Hospital,STAGE,Rayan Hospital Clinics,RAY_CATHLB,17455392,1117638816,14-01-2024,8.4,-25.2,681194.0,VL,Int Order Direct Ship,3.0,5.77687,-17.3306,519.0,2998.19378
6020040013,XYLOCAINE-2% INJECTION -1'S,Medicine,Rayan Hospital,RAY_IVF,RYN 11212-IVF,,15455116,1117717661,14-01-2024,8.4,-25.2,681192.0,VL,Move Order Issue,3.0,5.77687,-17.3306,516.0,2980.86318
6020040013,XYLOCAINE-2% INJECTION -1'S,Medicine,Rayan Hospital,RYN_IP,,,,1118174166,15-01-2024,8.4,-8.4,681194.0,VL,Issue to Patient,1.0,5.77687,-5.77687,515.0,2975.08631
6020040013,XYLOCAINE-2% INJECTION -1'S,Medicine,Rayan Hospital,RAY_OPTHA,RYN 11216-Ophthalmology,,15472391,1118617952,15-01-2024,8.4,-8.4,681194.0,VL,Move Order Issue,1.0,5.7769,-5.7769,674.0,3893.63099
6020040013,XYLOCAINE-2% INJECTION -1'S,Medicine,Rayan Hospital,RAY_OPTHA,RYN 11216-Ophthalmology,,9647828,1119055571,16-01-2024,8.4,-8.4,681189.0,VL,Move Order Issue,1.0,5.7769,-5.7769,673.0,3887.85409
6020040013,XYLOCAINE-2% INJECTION -1'S,Medicine,Rayan Hospital,STAGE,Rayan Hospital Clinics,RAY_LDR,17458406,1119570947,17-01-2024,8.4,-168.0,681194.0,VL,Int Order Direct Ship,20.0,5.7769,-115.53801,654.0,3778.09298
6020040013,XYLOCAINE-2% INJECTION -1'S,Medicine,Rayan Hospital,STAGE,Rayan Hospital Clinics,RAY_OR,17458416,1119571820,17-01-2024,8.4,-84.0,681194.0,VL,Int Order Direct Ship,10.0,5.7769,-57.76901,644.0,3720.32398
6020040013,XYLOCAINE-2% INJECTION -1'S,Medicine,Rayan Hospital,RAY_OBGY2F,RYN 11215-OB&Gyne,,15482055,1120296935,18-01-2024,8.4,-16.8,681193.0,VL,Move Order Issue,2.0,5.7769,-11.5538,642.0,3708.77018
6020040013,XYLOCAINE-2% INJECTION -1'S,Medicine,Rayan Hospital,RAY_DERMA,RYN 11204-Dermatology,,15481230,1120336285,18-01-2024,8.4,-25.2,681193.0,VL,Move Order Issue,3.0,5.7769,-17.3307,639.0,3691.43947
6020040013,XYLOCAINE-2% INJECTION -1'S,Medicine,Rayan Hospital,RYN_IP,,,,1120454804,18-01-2024,8.4,-16.8,681195.0,VL,Issue to Patient,2.0,5.7769,-11.5538,637.0,3679.88567
6020040013,XYLOCAINE-2% INJECTION -1'S,Medicine,Rayan Hospital,STAGE,Rayan Hospital Clinics,RAY_ER,17458407,1120587180,19-01-2024,8.4,-25.2,681194.0,VL,Int Order Direct Ship,3.0,5.7769,-17.3307,634.0,3662.55497
6020040013,XYLOCAINE-2% INJECTION -1'S,Medicine,Rayan Hospital,RAY_GENSUR,RYN 11227-General Surgery Clinic,,15486061,1122095511,22-01-2024,8.4,-621.6,681192.0,VL,Move Order Issue,74.0,5.7769,-427.49064,560.0,3235.06433
6020040013,XYLOCAINE-2% INJECTION -1'S,Medicine,Rayan Hospital,RAY_GENSUR,RYN 11227-General Surgery Clinic,,15486061,1122095511,22-01-2024,8.4,-134.4,681193.0,VL,Move Order Issue,16.0,5.7769,-92.43041,544.0,3142.63392
6020040013,XYLOCAINE-2% INJECTION -1'S,Medicine,Rayan Hospital,RAY_GENSUR,RYN 11227-General Surgery Clinic,,15486061,1122095511,22-01-2024,8.4,-92.4,681194.0,VL,Move Order Issue,11.0,5.7769,-63.54591,533.0,3079.08801
6020040013,XYLOCAINE-2% INJECTION -1'S,Medicine,Rayan Hospital,STAGE,Rayan Hospital Clinics,RAY_LDR,17461393,1122281741,22-01-2024,8.4,-126.0,681194.0,VL,Int Order Direct Ship,15.0,5.7769,-86.65351,518.0,2992.4345
6020040013,XYLOCAINE-2% INJECTION -1'S,Medicine,Rayan Hospital,RAY_DERMA,RYN 11204-Dermatology,,15494612,1122990174,23-01-2024,8.4,-16.8,681193.0,VL,Move Order Issue,2.0,5.80003,-11.60005,616.0,3572.8158
6020040013,XYLOCAINE-2% INJECTION -1'S,Medicine,Rayan Hospital,RAY_DERMA,RYN 11204-Dermatology,,15494612,1122990174,23-01-2024,8.4,-16.8,681194.0,VL,Move Order Issue,2.0,5.80003,-11.60005,614.0,3561.21575
6020040013,XYLOCAINE-2% INJECTION -1'S,Medicine,Rayan Hospital,RAY_OPTHA,RYN 11216-Ophthalmology,,15494936,1123090107,23-01-2024,8.4,-16.8,681194.0,VL,Move Order Issue,2.0,5.80003,-11.60005,612.0,3549.6157
6020040013,XYLOCAINE-2% INJECTION -1'S,Medicine,Rayan Hospital,RAY_ORPCLN,RYN 11217-Orthopedics,,15495231,1123395287,24-01-2024,8.4,-504.0,681192.0,VL,Move Order Issue,60.0,5.80003,-348.00154,552.0,3201.61416
6020040013,XYLOCAINE-2% INJECTION -1'S,Medicine,Rayan Hospital,RAY_ORPCLN,RYN 11217-Orthopedics,,15495231,1123395287,24-01-2024,8.4,-252.0,681193.0,VL,Move Order Issue,30.0,5.80003,-174.00077,522.0,3027.61339
6020040013,XYLOCAINE-2% INJECTION -1'S,Medicine,Rayan Hospital,STAGE,Rayan Hospital Clinics,RAY_CATHLB,17462975,1123421769,24-01-2024,8.4,-42.0,681194.0,VL,Int Order Direct Ship,5.0,5.80003,-29.00013,517.0,2998.61326
6020040013,XYLOCAINE-2% INJECTION -1'S,Medicine,Rayan Hospital,STAGE,Rayan Hospital Clinics,RAY_OR,17463482,1123502717,24-01-2024,8.4,-84.0,681194.0,VL,Int Order Direct Ship,10.0,5.80003,-58.00026,507.0,2940.613
6020040013,XYLOCAINE-2% INJECTION -1'S,Medicine,Rayan Hospital,RAY_ENSCPY,RYN 11105-Endoscopy,,15499438,1123687474,24-01-2024,8.4,-8.4,681190.0,VL,Move Order Issue,1.0,5.80003,-5.80003,506.0,2934.81298
6020040013,XYLOCAINE-2% INJECTION -1'S,Medicine,Rayan Hospital,RYN_IP,,,,1123799254,25-01-2024,8.4,-8.4,681195.0,VL,Issue to Patient,1.0,5.80003,-5.80003,505.0,2929.01295
6020040013,XYLOCAINE-2% INJECTION -1'S,Medicine,Rayan Hospital,RYN_IP,,,,1123800224,25-01-2024,8.4,-8.4,681195.0,VL,Issue to Patient,1.0,5.80003,-5.80003,504.0,2923.21293
6020040013,XYLOCAINE-2% INJECTION -1'S,Medicine,Rayan Hospital,STAGE,Rayan Hospital Clinics,RAY_ER,17463497,1123841191,25-01-2024,8.4,-8.4,681194.0,VL,Int Order Direct Ship,1.0,5.80003,-5.80003,503.0,2917.4129
6020040013,XYLOCAINE-2% INJECTION -1'S,Medicine,Rayan Hospital,RYN_IP,,,,1124324480,26-01-2024,8.4,-8.4,681194.0,VL,Issue to Patient,1.0,5.80003,-5.80003,502.0,2911.61288
6020040013,XYLOCAINE-2% INJECTION -1'S,Medicine,Rayan Hospital,STAGE,Rayan Hospital Clinics,RAY_LDR,17463475,1124413863,26-01-2024,8.4,-126.0,681194.0,VL,Int Order Direct Ship,15.0,5.80003,-87.00038,487.0,2824.61249
6020040013,XYLOCAINE-2% INJECTION -1'S,Medicine,Rayan Hospital,RAY_IVF,RYN 11212-IVF,,15499056,1124443972,26-01-2024,8.4,-8.4,681192.0,VL,Move Order Issue,1.0,5.80003,-5.80003,486.0,2818.81247
6020040013,XYLOCAINE-2% INJECTION -1'S,Medicine,Rayan Hospital,RAY_IVF,RYN 11212-IVF,,15499056,1124443972,26-01-2024,8.4,-8.4,681193.0,VL,Move Order Issue,1.0,5.80003,-5.80003,485.0,2813.01244
6020040013,XYLOCAINE-2% INJECTION -1'S,Medicine,Rayan Hospital,RAY_IVF,RYN 11212-IVF,,15499056,1124443972,26-01-2024,8.4,-25.2,681194.0,VL,Move Order Issue,3.0,5.80003,-17.40008,482.0,2795.61236
6020040013,XYLOCAINE-2% INJECTION -1'S,Medicine,Rayan Hospital,RYN_IP,,,,1124494728,26-01-2024,8.4,-8.4,681195.0,VL,Issue to Patient,1.0,5.80003,-5.80003,481.0,2789.81234
6020040013,XYLOCAINE-2% INJECTION -1'S,Medicine,Rayan Hospital,STAGE,Rayan Hospital Clinics,RAY_OR,17466832,1124670420,27-01-2024,8.4,-84.0,681194.0,VL,Int Order Direct Ship,10.0,5.80003,-58.00026,471.0,2731.81208
6020040013,XYLOCAINE-2% INJECTION -1'S,Medicine,Rayan Hospital,STAGE,Rayan Hospital Clinics,RAY_ER,17466912,1125363904,28-01-2024,8.4,-16.8,681194.0,VL,Int Order Direct Ship,2.0,5.80003,-11.60005,469.0,2720.21203
6020040013,XYLOCAINE-2% INJECTION -1'S,Medicine,Rayan Hospital,RYN_IP,,,,1126129395,29-01-2024,8.4,-8.4,681195.0,VL,Issue to Patient,1.0,5.80003,-5.80003,468.0,2714.412
6020040013,XYLOCAINE-2% INJECTION -1'S,Medicine,Rayan Hospital,RYN_IP,,,,1126395920,30-01-2024,8.4,-8.4,681195.0,VL,Issue to Patient,1.0,5.80003,-5.80003,467.0,2708.61198
6020040013,XYLOCAINE-2% INJECTION -1'S,Medicine,Rayan Hospital,STAGE,Rayan Hospital Clinics,RAY_ER,17493688,1126532380,30-01-2024,8.4,-42.0,681194.0,VL,Int Order Direct Ship,5.0,5.80003,-29.00013,462.0,2679.61185
6020040013,XYLOCAINE-2% INJECTION -1'S,Medicine,Rayan Hospital,RYN_IP,,,,1126847873,30-01-2024,8.4,-8.4,681195.0,VL,Issue to Patient,1.0,5.80003,-5.80003,461.0,2673.81182
6020040013,XYLOCAINE-2% INJECTION -1'S,Medicine,Rayan Hospital,RAY_OBGY2F,RYN 11215-OB&Gyne,,15517199,1126919311,30-01-2024,8.4,-8.4,681193.0,VL,Move Order Issue,1.0,5.80003,-5.80003,460.0,2668.0118
6020040013,XYLOCAINE-2% INJECTION -1'S,Medicine,Rayan Hospital,RAY_OBGY2F,RYN 11215-OB&Gyne,,15517199,1126919311,30-01-2024,8.4,-33.6,681194.0,VL,Move Order Issue,4.0,5.80003,-23.2001,456.0,2644.8117
6020040013,XYLOCAINE-2% INJECTION -1'S,Medicine,Rayan Hospital,RYN_IP,,,,1126982979,31-01-2024,8.4,-8.4,681195.0,VL,Issue to Patient,1.0,5.80003,-5.80003,455.0,2639.01167
6020040013,XYLOCAINE-2% INJECTION -1'S,Medicine,Rayan Hospital,STAGE,Rayan Hospital Clinics,RAY_LDR,17493622,1127071883,31-01-2024,8.4,-126.0,681195.0,VL,Int Order Direct Ship,15.0,5.80003,-87.00038,440.0,2552.01129
6020040013,XYLOCAINE-2% INJECTION -1'S,Medicine,Rayan Hospital,RAY_IVF,RYN 11212-IVF,,15520019,1127166436,31-01-2024,8.4,-16.8,681194.0,VL,Move Order Issue,2.0,5.80003,-11.60005,438.0,2540.41123
6020040013,XYLOCAINE-2% INJECTION -1'S,Medicine,Rayan Hospital,STAGE,Rayan Hospital Clinics,RAY_CATHLB,17493618,1127166906,31-01-2024,8.4,-84.0,681195.0,VL,Int Order Direct Ship,10.0,5.80003,-58.00026,428.0,2482.41098
6020040013,XYLOCAINE-2% INJECTION -1'S,Medicine,Rayan Hospital,RYN_IP,,,,1127291138,31-01-2024,8.4,-8.4,681195.0,VL,Issue to Patient,1.0,5.82626,-5.82626,547.0,3186.96234
6020040013,XYLOCAINE-2% INJECTION -1'S,Medicine,Rayan Hospital,STAGE,Rayan Hospital Clinics,RAY_ER,17494382,1127580307,01-02-2024,8.4,-16.8,681195.0,VL,Int Order Direct Ship,2.0,5.82626,-11.65251,545.0,3175.30983
6020040013,XYLOCAINE-2% INJECTION -1'S,Medicine,Rayan Hospital,RYN_IP,,,,1127605215,01-02-2024,8.4,-8.4,681195.0,VL,Issue to Patient,1.0,5.82626,-5.82626,544.0,3169.48357
6020040013,XYLOCAINE-2% INJECTION -1'S,Medicine,Rayan Hospital,RYN_IP,,,,1128164221,02-02-2024,8.4,-8.4,681195.0,VL,Issue to Patient,1.0,5.82626,-5.82626,543.0,3163.65731
6020040013,XYLOCAINE-2% INJECTION -1'S,Medicine,Rayan Hospital,RYN_IP,,,,1128343961,03-02-2024,8.4,-8.4,681195.0,VL,Issue to Patient,1.0,5.82626,-5.82626,542.0,3157.83106
6020040013,XYLOCAINE-2% INJECTION -1'S,Medicine,Rayan Hospital,STAGE,Rayan Hospital Clinics,RAY_LDR,17497831,1128925815,04-02-2024,8.4,-42.0,681195.0,VL,Int Order Direct Ship,5.0,5.82626,-29.13128,537.0,3128.69977
6020040013,XYLOCAINE-2% INJECTION -1'S,Medicine,Rayan Hospital,RAY_OPTHA,RYN 11216-Ophthalmology,,12034693,1129118764,04-02-2024,8.4,-8.4,681194.0,VL,Move Order Issue,1.0,5.82626,-5.82626,536.0,3122.87352
6020040013,XYLOCAINE-2% INJECTION -1'S,Medicine,Rayan Hospital,RAY_DERMA,RYN 11204-Dermatology,,15530365,1129427770,04-02-2024,8.4,-25.2,681194.0,VL,Move Order Issue,3.0,5.82626,-17.47877,533.0,3105.39475
6020040013,XYLOCAINE-2% INJECTION -1'S,Medicine,Rayan Hospital,RYN_IP,,,,1130698564,07-02-2024,8.4,-8.4,681195.0,VL,Issue to Patient,1.0,5.82626,-5.82626,532.0,3099.56849
6020040013,XYLOCAINE-2% INJECTION -1'S,Medicine,Rayan Hospital,RYN_IP,,,,1130858262,07-02-2024,8.4,-8.4,681195.0,VL,Issue to Patient,1.0,5.82626,-5.82626,531.0,3093.74223
6020040013,XYLOCAINE-2% INJECTION -1'S,Medicine,Rayan Hospital,RAY_UROLGY,RYN 11225-Urology,,15536511,1130870296,07-02-2024,8.4,-16.8,681192.0,VL,Move Order Issue,2.0,5.82626,-11.65251,529.0,3082.08972
6020040013,XYLOCAINE-2% INJECTION -1'S,Medicine,Rayan Hospital,STAGE,Rayan Hospital Clinics,RAY_OR,17500950,1130876850,07-02-2024,8.4,-252.0,681195.0,VL,Int Order Direct Ship,30.0,5.82626,-174.7877,499.0,2907.30202
6020040013,XYLOCAINE-2% INJECTION -1'S,Medicine,Rayan Hospital,STAGE,Rayan Hospital Clinics,RAY_LDR,17500947,1130935596,07-02-2024,8.4,-84.0,681195.0,VL,Int Order Direct Ship,10.0,5.82626,-58.26257,490.0,2854.86572
6020040013,XYLOCAINE-2% INJECTION -1'S,Medicine,Rayan Hospital,RYN_IP,,,,1132535170,10-02-2024,8.4,-8.4,681195.0,VL,Issue to Patient,1.0,5.82626,-5.82626,489.0,2849.03946
6020040013,XYLOCAINE-2% INJECTION -1'S,Medicine,Rayan Hospital,RYN_IP,,,,1132755563,11-02-2024,8.4,-8.4,681195.0,VL,Issue to Patient,1.0,5.82626,-5.82626,488.0,2843.2132
6020040013,XYLOCAINE-2% INJECTION -1'S,Medicine,Rayan Hospital,RYN_IP,,,,1133282202,11-02-2024,8.4,-8.4,681195.0,VL,Issue to Patient,1.0,5.82626,-5.82626,487.0,2837.38695
6020040013,XYLOCAINE-2% INJECTION -1'S,Medicine,Rayan Hospital,RYN_IP,,,,1133480486,12-02-2024,8.4,-8.4,681195.0,VL,Issue to Patient,1.0,5.82626,-5.82626,486.0,2831.56069
6020040013,XYLOCAINE-2% INJECTION -1'S,Medicine,Rayan Hospital,STAGE,Rayan Hospital Clinics,RAY_CATHLB,17503730,1133528290,12-02-2024,8.4,-100.8,681195.0,VL,Int Order Direct Ship,12.0,5.82626,-69.91508,474.0,2761.64561
6020040013,XYLOCAINE-2% INJECTION -1'S,Medicine,Rayan Hospital,RYN_IP,,,,1133919750,13-02-2024,8.4,-8.4,681195.0,VL,Issue to Patient,1.0,5.82626,-5.82626,473.0,2755.81935
6020040013,XYLOCAINE-2% INJECTION -1'S,Medicine,Rayan Hospital,RAY_IVF,RYN 11212-IVF,,15551554,1134011690,13-02-2024,8.4,-16.8,681195.0,VL,Move Order Issue,2.0,5.82626,-11.65251,471.0,2744.16684
6020040013,XYLOCAINE-2% INJECTION -1'S,Medicine,Rayan Hospital,STAGE,Rayan Hospital Clinics,RAY_ER,17503722,1134348135,13-02-2024,8.4,-16.8,681195.0,VL,Int Order Direct Ship,2.0,5.82626,-11.65251,469.0,2732.51433
6020040013,XYLOCAINE-2% INJECTION -1'S,Medicine,Rayan Hospital,RYN_IP,,,,1134530449,13-02-2024,8.4,-8.4,681195.0,VL,Issue to Patient,1.0,5.82626,-5.82626,468.0,2726.68807
6020040013,XYLOCAINE-2% INJECTION -1'S,Medicine,Rayan Hospital,RYN_IP,,,,1135035615,14-02-2024,8.4,-8.4,681195.0,VL,Issue to Patient,1.0,5.85427,-5.85427,667.0,3904.7965
6020040013,XYLOCAINE-2% INJECTION -1'S,Medicine,Rayan Hospital,RAY_DERMA,RYN 11204-Dermatology,,15563849,1135595836,15-02-2024,8.4,-33.6,681194.0,VL,Move Order Issue,4.0,5.85427,-23.41707,663.0,3881.37943
6020040013,XYLOCAINE-2% INJECTION -1'S,Medicine,Rayan Hospital,RAY_DERMA,RYN 11204-Dermatology,,15563849,1135595836,15-02-2024,8.4,-25.2,681195.0,VL,Move Order Issue,3.0,5.85427,-17.5628,660.0,3863.81663
6020040013,XYLOCAINE-2% INJECTION -1'S,Medicine,Rayan Hospital,RYN_IP,,,,1135754679,16-02-2024,8.4,-8.4,681195.0,VL,Issue to Patient,1.0,5.85427,-5.85427,659.0,3857.96236
6020040013,XYLOCAINE-2% INJECTION -1'S,Medicine,Rayan Hospital,STAGE,Rayan Hospital Clinics,RAY_OR,17508785,1136020790,17-02-2024,8.4,-84.0,681195.0,VL,Int Order Direct Ship,10.0,5.85427,-58.54268,649.0,3799.41968
6020040013,XYLOCAINE-2% INJECTION -1'S,Medicine,Rayan Hospital,RAY_GENSUR,RYN 11227-General Surgery Clinic,,15562559,1136045662,17-02-2024,8.4,-310.8,681194.0,VL,Move Order Issue,37.0,5.85427,-216.6079,612.0,3582.81178
6020040013,XYLOCAINE-2% INJECTION -1'S,Medicine,Rayan Hospital,RAY_GENSUR,RYN 11227-General Surgery Clinic,,15562559,1136045662,17-02-2024,8.4,-184.8,681195.0,VL,Move Order Issue,22.0,5.85427,-128.79389,590.0,3454.01789
6020040013,XYLOCAINE-2% INJECTION -1'S,Medicine,Rayan Hospital,STAGE,Rayan Hospital Clinics,RAY_LDR,17508782,1136571049,18-02-2024,8.4,-84.0,681195.0,VL,Int Order Direct Ship,10.0,5.85427,-58.54268,580.0,3395.47522
6020040013,XYLOCAINE-2% INJECTION -1'S,Medicine,Rayan Hospital,RAY_OPTHA,RYN 11216-Ophthalmology,,15571236,1136972788,18-02-2024,8.4,-16.8,681195.0,VL,Move Order Issue,2.0,5.85427,-11.70854,578.0,3383.76668
6020040013,XYLOCAINE-2% INJECTION -1'S,Medicine,Rayan Hospital,STAGE,Rayan Hospital Clinics,RAY_ER,17507791,1137084583,19-02-2024,8.4,-42.0,681195.0,VL,Int Order Direct Ship,5.0,5.85427,-29.27134,573.0,3354.49534
6020040013,XYLOCAINE-2% INJECTION -1'S,Medicine,Rayan Hospital,STAGE,Rayan Hospital Clinics,RAY_LDR,17508495,1137174966,19-02-2024,8.4,-168.0,681195.0,VL,Int Order Direct Ship,20.0,5.85427,-117.08535,553.0,3237.40999
6020040013,XYLOCAINE-2% INJECTION -1'S,Medicine,Rayan Hospital,RAY_IVF,RYN 11212-IVF,,15569741,1137265564,19-02-2024,8.4,-25.2,681195.0,VL,Move Order Issue,3.0,5.85427,-17.5628,550.0,3219.84719
6020040013,XYLOCAINE-2% INJECTION -1'S,Medicine,Rayan Hospital,RYN_IP,,,,1137665124,20-02-2024,8.4,-8.4,681195.0,VL,Issue to Patient,1.0,5.85427,-5.85427,549.0,3213.99292
6020040013,XYLOCAINE-2% INJECTION -1'S,Medicine,Rayan Hospital,RAY_DERMA,RYN 11204-Dermatology,,15579214,1138513402,21-02-2024,8.4,-25.2,681195.0,VL,Move Order Issue,3.0,5.85427,-17.5628,546.0,3196.43012
6020040013,XYLOCAINE-2% INJECTION -1'S,Medicine,Rayan Hospital,RYN_IP,,,,1139219560,22-02-2024,8.4,-8.4,681195.0,VL,Issue to Patient,1.0,5.85427,-5.85427,545.0,3190.57585
6020040013,XYLOCAINE-2% INJECTION -1'S,Medicine,Rayan Hospital,RYN_IP,,,,1139298709,23-02-2024,8.4,-8.4,681195.0,VL,Issue to Patient,1.0,5.85427,-5.85427,545.0,3190.57585
6020040013,XYLOCAINE-2% INJECTION -1'S,Medicine,Rayan Hospital,STAGE,Rayan Hospital Clinics,RAY_OR,17512256,1139639762,24-02-2024,8.4,-84.0,681195.0,VL,Int Order Direct Ship,10.0,5.85427,-58.54268,535.0,3132.03317
6020040013,XYLOCAINE-2% INJECTION -1'S,Medicine,Rayan Hospital,RYN_IP,,,,1139890784,24-02-2024,8.4,-8.4,681195.0,VL,Issue to Patient,1.0,5.85427,-5.85427,534.0,3126.17891
6020040013,XYLOCAINE-2% INJECTION -1'S,Medicine,Rayan Hospital,STAGE,Rayan Hospital Clinics,RAY_LDR,17512249,1140121041,25-02-2024,8.4,-210.0,681195.0,VL,Int Order Direct Ship,25.0,5.85427,-146.35669,509.0,2979.82222
6020040013,XYLOCAINE-2% INJECTION -1'S,Medicine,Rayan Hospital,STAGE,Rayan Hospital Clinics,RAY_LDR,17512250,1140121197,25-02-2024,8.4,-142.8,681195.0,VL,Int Order Direct Ship,17.0,5.85427,-99.52255,492.0,2880.29967
6020040013,XYLOCAINE-2% INJECTION -1'S,Medicine,Rayan Hospital,STAGE,Rayan Hospital Clinics,RAY_ER,17512378,1140670029,26-02-2024,8.4,-16.8,681195.0,VL,Int Order Direct Ship,2.0,5.85427,-11.70854,490.0,2868.59113
6020040013,XYLOCAINE-2% INJECTION -1'S,Medicine,Rayan Hospital,RAY_GENSUR,RYN 11227-General Surgery Clinic,,15592056,1140758290,26-02-2024,8.4,-142.8,681195.0,VL,Move Order Issue,17.0,5.85427,-99.52255,473.0,2769.06858
6020040013,XYLOCAINE-2% INJECTION -1'S,Medicine,Rayan Hospital,STAGE,Rayan Hospital Clinics,RAY_LDR,17514083,1140793481,26-02-2024,8.4,-126.0,681195.0,VL,Int Order Direct Ship,15.0,5.85427,-87.81401,458.0,2681.25457
6020040013,XYLOCAINE-2% INJECTION -1'S,Medicine,Rayan Hospital,RYN_IP,,,,1141229840,27-02-2024,8.4,-8.4,681195.0,VL,Issue to Patient,1.0,5.85427,-5.85427,457.0,2675.4003
6020040013,XYLOCAINE-2% INJECTION -1'S,Medicine,Rayan Hospital,RAY_ORPCLN,RYN 11217-Orthopedics,,15597861,1141686187,27-02-2024,8.4,-134.4,681194.0,VL,Move Order Issue,16.0,5.85702,-93.71225,461.0,2700.08432
6020040013,XYLOCAINE-2% INJECTION -1'S,Medicine,Rayan Hospital,RAY_ORPCLN,RYN 11217-Orthopedics,,15597861,1141686187,27-02-2024,8.4,-285.6,681195.0,VL,Move Order Issue,34.0,5.85702,-199.13854,427.0,2500.94578
6020040013,XYLOCAINE-2% INJECTION -1'S,Medicine,Rayan Hospital,RYN_IP,,,,1141914987,28-02-2024,8.4,-8.4,681195.0,VL,Issue to Patient,1.0,5.85702,-5.85702,426.0,2495.08876
6020040013,XYLOCAINE-2% INJECTION -1'S,Medicine,Rayan Hospital,STAGE,Rayan Hospital Clinics,RAY_OR,17515170,1141930642,28-02-2024,8.4,-168.0,681196.0,VL,Int Order Direct Ship,20.0,5.85702,-117.14032,406.0,2377.94844
6020040013,XYLOCAINE-2% INJECTION -1'S,Medicine,Rayan Hospital,STAGE,Rayan Hospital Clinics,RAY_CATHLB,17513274,1141934801,28-02-2024,8.4,-84.0,681195.0,VL,Int Order Direct Ship,10.0,5.85702,-58.57016,396.0,2319.37828
6020040013,XYLOCAINE-2% INJECTION -1'S,Medicine,Rayan Hospital,RYN_IP,,,,1142390418,29-02-2024,8.4,-8.4,681195.0,VL,Issue to Patient,1.0,5.85702,-5.85702,395.0,2313.52127
6020040013,XYLOCAINE-2% INJECTION -1'S,Medicine,Rayan Hospital,RAY_IVF,RYN 11212-IVF,,15603909,1142586242,29-02-2024,8.4,-8.4,681195.0,VL,Move Order Issue,1.0,5.85702,-5.85702,394.0,2307.66425
6020040013,XYLOCAINE-2% INJECTION -1'S,Medicine,Rayan Hospital,RYN_IP,,,,1143068582,01-03-2024,8.4,-8.4,681195.0,VL,Issue to Patient,1.0,5.85702,-5.85702,393.0,2301.80724
6020040013,XYLOCAINE-2% INJECTION -1'S,Medicine,Rayan Hospital,STAGE,Rayan Hospital Clinics,RAY_OR,17516993,1143226763,02-03-2024,8.4,-84.0,681195.0,VL,Int Order Direct Ship,10.0,5.85702,-58.57016,383.0,2243.23708
6020040013,XYLOCAINE-2% INJECTION -1'S,Medicine,Rayan Hospital,STAGE,Rayan Hospital Clinics,RAY_LDR,17516982,1143228189,02-03-2024,8.4,-84.0,681195.0,VL,Int Order Direct Ship,10.0,5.85702,-58.57016,373.0,2184.66692
6020040013,XYLOCAINE-2% INJECTION -1'S,Medicine,Rayan Hospital,STAGE,Rayan Hospital Clinics,RAY_ER,17517005,1143236023,02-03-2024,8.4,-33.6,681195.0,VL,Int Order Direct Ship,4.0,5.85702,-23.42806,369.0,2161.23886
6020040013,XYLOCAINE-2% INJECTION -1'S,Medicine,Rayan Hospital,RYN_IP,,,,1143300125,02-03-2024,8.4,-8.4,681195.0,VL,Issue to Patient,1.0,5.85702,-5.85702,368.0,2155.38184
6020040013,XYLOCAINE-2% INJECTION -1'S,Medicine,Rayan Hospital,RAY_ENT,RYN 11205-E.N.T. (Otolaryngology),,15606023,1143313665,02-03-2024,8.4,-8.4,681187.0,VL,Move Order Issue,1.0,5.85702,-5.85702,367.0,2149.52482
6020040013,XYLOCAINE-2% INJECTION -1'S,Medicine,Rayan Hospital,RYN_IP,,,,1145916046,06-03-2024,8.4,-8.4,681195.0,VL,Issue to Patient,1.0,5.85702,-5.85702,367.0,2149.52482
6020040013,XYLOCAINE-2% INJECTION -1'S,Medicine,Rayan Hospital,RYN_IP,,,,1146234104,07-03-2024,8.4,-8.4,681195.0,VL,Issue to Patient,1.0,5.85702,-5.85702,366.0,2143.66781
6020040013,XYLOCAINE-2% INJECTION -1'S,Medicine,Rayan Hospital,RYN_IP,,,,1146657170,07-03-2024,8.4,-8.4,681195.0,VL,Issue to Patient,1.0,5.85702,-5.85702,365.0,2137.81079
6020040013,XYLOCAINE-2% INJECTION -1'S,Medicine,Rayan Hospital,RAY_DERMA,RYN 11204-Dermatology,,15629186,1146670308,07-03-2024,8.4,-67.2,681195.0,VL,Move Order Issue,8.0,5.85702,-46.85613,357.0,2090.95467
6020040013,XYLOCAINE-2% INJECTION -1'S,Medicine,Rayan Hospital,RYN_IP,,,,1146682091,07-03-2024,8.4,-8.4,681195.0,VL,Issue to Patient,1.0,5.85702,-5.85702,356.0,2085.09765
6020040013,XYLOCAINE-2% INJECTION -1'S,Medicine,Rayan Hospital,RYN_IP,,,,1146706943,07-03-2024,8.4,-8.4,681195.0,VL,Issue to Patient,1.0,5.85702,-5.85702,355.0,2079.24063
6020040013,XYLOCAINE-2% INJECTION -1'S,Medicine,Rayan Hospital,STAGE,Rayan Hospital Clinics,RAY_OR,17522791,1147155911,09-03-2024,8.4,-126.0,681195.0,VL,Int Order Direct Ship,15.0,5.85702,-87.85524,341.0,1997.24241
6020040013,XYLOCAINE-2% INJECTION -1'S,Medicine,Rayan Hospital,STAGE,Rayan Hospital Clinics,RAY_PTDNWC,17524221,1147861420,10-03-2024,6.6,-13.2,681174.0,VL,Int Order Direct Ship,2.0,5.85702,-11.71403,339.0,1985.52838
6020040013,XYLOCAINE-2% INJECTION -1'S,Medicine,Rayan Hospital,RAY_NEURO,RYN 11214-Neurology,,15636580,1148015892,10-03-2024,8.4,-16.8,681192.0,VL,Move Order Issue,2.0,5.85702,-11.71403,337.0,1973.81435
6020040013,XYLOCAINE-2% INJECTION -1'S,Medicine,Rayan Hospital,RAY_NEURO,RYN 11214-Neurology,,15636580,1148015892,10-03-2024,8.4,-8.4,681194.0,VL,Move Order Issue,1.0,5.85702,-5.85702,336.0,1967.95733
6020040013,XYLOCAINE-2% INJECTION -1'S,Medicine,Rayan Hospital,RAY_NEURO,RYN 11214-Neurology,,15636580,1148015892,10-03-2024,8.4,-16.8,681195.0,VL,Move Order Issue,2.0,5.85702,-11.71403,334.0,1956.2433
6020040013,XYLOCAINE-2% INJECTION -1'S,Medicine,Rayan Hospital,RYN_IP,,,,1148242194,10-03-2024,8.4,-8.4,681195.0,VL,Issue to Patient,1.0,5.85702,-5.85702,333.0,1950.38628
6020040013,XYLOCAINE-2% INJECTION -1'S,Medicine,Rayan Hospital,RAY_OPTHA,RYN 11216-Ophthalmology,,15638734,1148489211,11-03-2024,8.4,-25.2,681195.0,VL,Move Order Issue,3.0,5.85702,-17.57105,330.0,1932.81524
6020040013,XYLOCAINE-2% INJECTION -1'S,Medicine,Rayan Hospital,STAGE,Rayan Hospital Clinics,RAY_CATHLB,17523452,1148555547,11-03-2024,6.6,-105.6,681183.0,VL,Int Order Direct Ship,16.0,5.85702,-93.71225,314.0,1839.10298
6020040013,XYLOCAINE-2% INJECTION -1'S,Medicine,Rayan Hospital,STAGE,Rayan Hospital Clinics,RAY_OR,17523571,1148572208,11-03-2024,8.4,-84.0,681193.0,VL,Int Order Direct Ship,10.0,5.85702,-58.57016,304.0,1780.53282
6020040013,XYLOCAINE-2% INJECTION -1'S,Medicine,Rayan Hospital,STAGE,Rayan Hospital Clinics,RAY_LDR,17523561,1148742928,12-03-2024,6.6,-66.0,681183.0,VL,Int Order Direct Ship,10.0,5.85702,-58.57016,294.0,1721.96267
6020040013,XYLOCAINE-2% INJECTION -1'S,Medicine,Rayan Hospital,STAGE,Rayan Hospital Clinics,RAY_ER,17523570,1148799289,12-03-2024,8.4,-25.2,681192.0,VL,Int Order Direct Ship,3.0,5.85702,-17.57105,291.0,1704.39162
6020040013,XYLOCAINE-2% INJECTION -1'S,Medicine,Rayan Hospital,STAGE,Rayan Hospital Clinics,RAY_ER,17523579,1148800602,12-03-2024,8.4,-42.0,681195.0,VL,Int Order Direct Ship,5.0,5.85702,-29.28508,286.0,1675.10654
6020040013,XYLOCAINE-2% INJECTION -1'S,Medicine,Rayan Hospital,RAY_IVF,RYN 11212-IVF,,15638672,1148853143,12-03-2024,8.4,-16.8,681195.0,VL,Move Order Issue,2.0,5.85702,-11.71403,284.0,1663.39251
6020040013,XYLOCAINE-2% INJECTION -1'S,Medicine,Rayan Hospital,STAGE,Rayan Hospital Clinics,RAY_LDR,17525893,1149340888,13-03-2024,8.4,-168.0,681195.0,VL,Int Order Direct Ship,20.0,5.85702,-117.14032,264.0,1546.25219
6020040013,XYLOCAINE-2% INJECTION -1'S,Medicine,Rayan Hospital,STAGE,Rayan Hospital Clinics,RAY_OR,17525922,1149355035,13-03-2024,8.4,-42.0,681195.0,VL,Int Order Direct Ship,5.0,5.85702,-29.28508,259.0,1516.96711
6020040013,XYLOCAINE-2% INJECTION -1'S,Medicine,Rayan Hospital,RAY_GENSUR,RYN 11227-General Surgery Clinic,,15644257,1150037126,14-03-2024,8.4,-369.6,681195.0,VL,Move Order Issue,44.0,6.08934,-267.93103,515.0,3136.01091
6020040013,XYLOCAINE-2% INJECTION -1'S,Medicine,Rayan Hospital,RAY_OPTHA,RYN 11216-Ophthalmology,,15649181,1150119228,14-03-2024,8.4,-16.8,681195.0,VL,Move Order Issue,2.0,6.08934,-12.17868,513.0,3123.83222
6020040013,XYLOCAINE-2% INJECTION -1'S,Medicine,Rayan Hospital,RAY_DERMA,RYN 11204-Dermatology,,15648436,1150185622,14-03-2024,8.4,-25.2,681195.0,VL,Move Order Issue,3.0,6.08934,-18.26802,510.0,3105.5642
6020040013,XYLOCAINE-2% INJECTION -1'S,Medicine,Rayan Hospital,STAGE,Rayan Hospital Clinics,RAY_OR,17527910,1151059999,17-03-2024,8.4,-126.0,681195.0,VL,Int Order Direct Ship,15.0,6.08934,-91.34012,495.0,3014.22408
6020040013,XYLOCAINE-2% INJECTION -1'S,Medicine,Rayan Hospital,STAGE,Rayan Hospital Clinics,RAY_CATHLB,17527904,1151077747,17-03-2024,8.4,-126.0,681195.0,VL,Int Order Direct Ship,15.0,6.08934,-91.34012,480.0,2922.88395
6020040013,XYLOCAINE-2% INJECTION -1'S,Medicine,Rayan Hospital,RYN_IP,,,,1151390178,17-03-2024,8.4,-8.4,681197.0,VL,Issue to Patient,1.0,6.08934,-6.08934,479.0,2916.79461
6020040013,XYLOCAINE-2% INJECTION -1'S,Medicine,Rayan Hospital,RAY_OPTHA,RYN 11216-Ophthalmology,,15655895,1151758720,18-03-2024,8.4,-8.4,681195.0,VL,Move Order Issue,1.0,6.08934,-6.08934,478.0,2910.70527
6020040013,XYLOCAINE-2% INJECTION -1'S,Medicine,Rayan Hospital,RYN_IP,,,,1152659188,20-03-2024,8.4,-8.4,681197.0,VL,Issue to Patient,1.0,6.08934,-6.08934,477.0,2904.61593
6020040013,XYLOCAINE-2% INJECTION -1'S,Medicine,Rayan Hospital,STAGE,Rayan Hospital Clinics,RAY_OR,17529797,1152826904,20-03-2024,8.4,-168.0,681197.0,VL,Int Order Direct Ship,20.0,6.08934,-121.78683,457.0,2782.8291
6020040013,XYLOCAINE-2% INJECTION -1'S,Medicine,Rayan Hospital,STAGE,Rayan Hospital Clinics,RAY_ER,17529713,1152854987,20-03-2024,8.4,-25.2,681197.0,VL,Int Order Direct Ship,3.0,6.08934,-18.26802,454.0,2764.56107
6020040013,XYLOCAINE-2% INJECTION -1'S,Medicine,Rayan Hospital,STAGE,Rayan Hospital Clinics,RAY_LDR,17529709,1152861783,20-03-2024,8.4,-75.6,681197.0,VL,Int Order Direct Ship,9.0,6.08934,-54.80407,445.0,2709.757
6020040013,XYLOCAINE-2% INJECTION -1'S,Medicine,Rayan Hospital,STAGE,Rayan Hospital Clinics,RAY_LDR,17529709,1152861787,20-03-2024,8.4,-8.4,681195.0,VL,Int Order Direct Ship,1.0,6.08934,-6.08934,444.0,2703.66766
6020040013,XYLOCAINE-2% INJECTION -1'S,Medicine,Rayan Hospital,RAY_UROLGY,RYN 11225-Urology,,15659886,1152894067,20-03-2024,8.4,-8.4,681192.0,VL,Move Order Issue,1.0,6.08934,-6.08934,443.0,2697.57831
6020040013,XYLOCAINE-2% INJECTION -1'S,Medicine,Rayan Hospital,RAY_UROLGY,RYN 11225-Urology,,15659886,1152894067,20-03-2024,8.4,-16.8,681194.0,VL,Move Order Issue,2.0,6.08934,-12.17868,441.0,2685.39963
6020040013,XYLOCAINE-2% INJECTION -1'S,Medicine,Rayan Hospital,RAY_UROLGY,RYN 11225-Urology,,15659886,1152894067,20-03-2024,8.4,-42.0,681195.0,VL,Move Order Issue,5.0,6.08934,-30.44671,436.0,2654.95292
6020040013,XYLOCAINE-2% INJECTION -1'S,Medicine,Rayan Hospital,RYN_IP,,,,1153220411,21-03-2024,8.4,-8.4,681197.0,VL,Issue to Patient,1.0,6.08934,-6.08934,435.0,2648.86358
6020040013,XYLOCAINE-2% INJECTION -1'S,Medicine,Rayan Hospital,RYN_IP,,,,1153220416,21-03-2024,8.4,-8.4,681197.0,VL,Issue to Patient,1.0,6.08934,-6.08934,434.0,2642.77424
6020040013,XYLOCAINE-2% INJECTION -1'S,Medicine,Rayan Hospital,RAY_IVF,RYN 11212-IVF,,15663767,1153519568,21-03-2024,8.4,-8.4,681195.0,VL,Move Order Issue,1.0,6.08934,-6.08934,433.0,2636.6849
6020040013,XYLOCAINE-2% INJECTION -1'S,Medicine,Rayan Hospital,STAGE,Rayan Hospital Clinics,RAY_LDR,17530275,1154121183,23-03-2024,8.4,-168.0,681197.0,VL,Int Order Direct Ship,20.0,6.08934,-121.78683,413.0,2514.89807
6020040013,XYLOCAINE-2% INJECTION -1'S,Medicine,Rayan Hospital,RYN_IP,,,,1154641048,24-03-2024,8.4,-8.4,681197.0,VL,Issue to Patient,1.0,6.08934,-6.08934,412.0,2508.80873
6020040013,XYLOCAINE-2% INJECTION -1'S,Medicine,Rayan Hospital,RYN_IP,,,,1154667023,24-03-2024,8.4,-8.4,681197.0,VL,Issue to Patient,1.0,6.08934,-6.08934,411.0,2502.71938
6020040013,XYLOCAINE-2% INJECTION -1'S,Medicine,Rayan Hospital,RYN_IP,,,,1154667503,24-03-2024,8.4,-8.4,681197.0,VL,Issue to Patient,1.0,6.08934,-6.08934,410.0,2496.63004
6020040013,XYLOCAINE-2% INJECTION -1'S,Medicine,Rayan Hospital,RYN_IP,,,,1154749081,24-03-2024,8.4,-8.4,681197.0,VL,Issue to Patient,1.0,6.16198,-6.16198,629.0,3875.8866
6020040013,XYLOCAINE-2% INJECTION -1'S,Medicine,Rayan Hospital,STAGE,Rayan Hospital Clinics,RAY_ER,17530283,1155005081,25-03-2024,8.4,-16.8,681197.0,VL,Int Order Direct Ship,2.0,6.16198,-12.32396,627.0,3863.56264
6020040013,XYLOCAINE-2% INJECTION -1'S,Medicine,Rayan Hospital,STAGE,Rayan Hospital Clinics,RAY_OR,17531950,1155063784,25-03-2024,8.4,-168.0,681197.0,VL,Int Order Direct Ship,20.0,6.16198,-123.23964,607.0,3740.323
6020040013,XYLOCAINE-2% INJECTION -1'S,Medicine,Rayan Hospital,STAGE,Rayan Hospital Clinics,RAY_LDR,17531949,1155081304,25-03-2024,8.4,-168.0,681197.0,VL,Int Order Direct Ship,20.0,6.16198,-123.23964,587.0,3617.08336
6020040013,XYLOCAINE-2% INJECTION -1'S,Medicine,Rayan Hospital,RAY_OPTHA,RYN 11216-Ophthalmology,,15677310,1155298874,25-03-2024,8.4,-8.4,681197.0,VL,Move Order Issue,1.0,6.16198,-6.16198,586.0,3610.92138
6020040013,XYLOCAINE-2% INJECTION -1'S,Medicine,Rayan Hospital,RYN_IP,,,,1156075453,27-03-2024,8.4,-8.4,681197.0,VL,Issue to Patient,1.0,6.16198,-6.16198,585.0,3604.7594
6020040013,XYLOCAINE-2% INJECTION -1'S,Medicine,Rayan Hospital,RYN_IP,,,,1156075988,27-03-2024,8.4,-8.4,681198.0,VL,Issue to Patient,1.0,6.16198,-6.16198,584.0,3598.59742
6020040013,XYLOCAINE-2% INJECTION -1'S,Medicine,Rayan Hospital,RYN_IP,,,,1156420296,27-03-2024,8.4,-8.4,681198.0,VL,Issue to Patient,1.0,6.16198,-6.16198,583.0,3592.43543
6020040013,XYLOCAINE-2% INJECTION -1'S,Medicine,Rayan Hospital,RYN_IP,,,,1157266823,29-03-2024,8.4,-8.4,681198.0,VL,Issue to Patient,1.0,6.16198,-6.16198,582.0,3586.27345
6020040013,XYLOCAINE-2% INJECTION -1'S,Medicine,Rayan Hospital,RYN_IP,,,,1157266838,29-03-2024,8.4,-8.4,681198.0,VL,Issue to Patient,1.0,6.16198,-6.16198,581.0,3580.11147
6020040013,XYLOCAINE-2% INJECTION -1'S,Medicine,Rayan Hospital,RYN_IP,,,,1157389487,30-03-2024,8.4,-8.4,681198.0,VL,Issue to Patient,1.0,6.16198,-6.16198,582.0,3586.27345
6020040013,XYLOCAINE-2% INJECTION -1'S,Medicine,Rayan Hospital,RYN_IP,,,,1157878944,31-03-2024,8.4,-8.4,681198.0,VL,Issue to Patient,1.0,6.16198,-6.16198,581.0,3580.11147
6020040013,XYLOCAINE-2% INJECTION -1'S,Medicine,Rayan Hospital,RYN_IP,,,,1157878949,31-03-2024,8.4,-8.4,681198.0,VL,Issue to Patient,1.0,6.16198,-6.16198,580.0,3573.94949
6020040013,XYLOCAINE-2% INJECTION -1'S,Medicine,Rayan Hospital,STAGE,Rayan Hospital Clinics,RAY_ER,17532620,1157888044,31-03-2024,8.4,-16.8,681197.0,VL,Int Order Direct Ship,2.0,6.16198,-12.32396,578.0,3561.62553
6020040013,XYLOCAINE-2% INJECTION -1'S,Medicine,Rayan Hospital,STAGE,Rayan Hospital Clinics,RAY_LDR,17535740,1157921444,31-03-2024,8.4,-126.0,681197.0,VL,Int Order Direct Ship,15.0,6.16198,-92.42973,563.0,3469.1958
6020040013,XYLOCAINE-2% INJECTION -1'S,Medicine,Rayan Hospital,RYN_IP,,,,1158183651,31-03-2024,8.4,-8.4,681198.0,VL,Issue to Patient,1.0,6.16198,-6.16198,562.0,3463.03382
6020040013,XYLOCAINE-2% INJECTION -1'S,Medicine,Rayan Hospital,RYN_IP,,,,1158183686,31-03-2024,8.4,-8.4,681198.0,VL,Issue to Patient,1.0,6.16198,-6.16198,561.0,3456.87183
6020040013,XYLOCAINE-2% INJECTION -1'S,Medicine,Rayan Hospital,RAY_ORPCLN,RYN 11217-Orthopedics,,15692135,1158274987,31-03-2024,8.4,-646.8,681195.0,VL,Move Order Issue,77.0,6.16198,-474.4726,484.0,2982.39923
6020040013,XYLOCAINE-2% INJECTION -1'S,Medicine,Rayan Hospital,RYN_IP,,,,1158683656,01-04-2024,8.4,-8.4,681198.0,VL,Issue to Patient,1.0,6.16198,-6.16198,483.0,2976.23725
6020040013,XYLOCAINE-2% INJECTION -1'S,Medicine,Rayan Hospital,RYN_IP,,,,1159010266,02-04-2024,8.4,-8.4,681198.0,VL,Issue to Patient,1.0,6.2131,-6.2131,775.0,4815.14975
6020040013,XYLOCAINE-2% INJECTION -1'S,Medicine,Rayan Hospital,RYN_IP,,,,1159403470,03-04-2024,8.4,-8.4,681198.0,VL,Issue to Patient,1.0,6.2131,-6.2131,774.0,4808.93665
6020040013,XYLOCAINE-2% INJECTION -1'S,Medicine,Rayan Hospital,RYN_IP,,,,1159407555,03-04-2024,8.4,-8.4,681198.0,VL,Issue to Patient,1.0,6.2131,-6.2131,773.0,4802.72356
6020040013,XYLOCAINE-2% INJECTION -1'S,Medicine,Rayan Hospital,STAGE,Rayan Hospital Clinics,RAY_OR,17537919,1159449315,03-04-2024,8.4,-84.0,681197.0,VL,Int Order Direct Ship,10.0,6.2131,-62.13096,763.0,4740.59259
6020040013,XYLOCAINE-2% INJECTION -1'S,Medicine,Rayan Hospital,STAGE,Rayan Hospital Clinics,RAY_LDR,17537908,1159492129,03-04-2024,8.4,-126.0,681197.0,VL,Int Order Direct Ship,15.0,6.2131,-93.19645,748.0,4647.39615
6020040013,XYLOCAINE-2% INJECTION -1'S,Medicine,Rayan Hospital,RAY_DERMA,RYN 11204-Dermatology,,15701708,1160092789,04-04-2024,8.4,-84.0,681195.0,VL,Move Order Issue,10.0,6.2131,-62.13096,738.0,4585.26518
6020040013,XYLOCAINE-2% INJECTION -1'S,Medicine,Rayan Hospital,RAY_DERMA,RYN 11204-Dermatology,,15701708,1160092789,04-04-2024,8.4,-16.8,681197.0,VL,Move Order Issue,2.0,6.2131,-12.42619,736.0,4572.83899
6020040013,XYLOCAINE-2% INJECTION -1'S,Medicine,Rayan Hospital,RYN_IP,,,,1160406243,05-04-2024,8.4,-8.4,681198.0,VL,Issue to Patient,1.0,6.2131,-6.2131,735.0,4566.62589
6020040013,XYLOCAINE-2% INJECTION -1'S,Medicine,Rayan Hospital,RYN_IP,,,,1160470938,06-04-2024,8.4,-8.4,681198.0,VL,Issue to Patient,1.0,6.2131,-6.2131,734.0,4560.4128
6020040013,XYLOCAINE-2% INJECTION -1'S,Medicine,Rayan Hospital,RYN_IP,,,,1160495703,06-04-2024,8.4,-8.4,681198.0,VL,Issue to Patient,1.0,6.2131,-6.2131,733.0,4554.1997
6020040013,XYLOCAINE-2% INJECTION -1'S,Medicine,Rayan Hospital,RYN_IP,,,,1160512087,06-04-2024,8.4,-8.4,681198.0,VL,Issue to Patient,1.0,6.2131,-6.2131,732.0,4547.9866
6020040013,XYLOCAINE-2% INJECTION -1'S,Medicine,Rayan Hospital,STAGE,Rayan Hospital Clinics,RAY_ER,17537361,1160514824,06-04-2024,8.4,-16.8,681197.0,VL,Int Order Direct Ship,2.0,6.2131,-12.42619,730.0,4535.56041
6020040013,XYLOCAINE-2% INJECTION -1'S,Medicine,Rayan Hospital,RAY_ENSCPY,RYN 11105-Endoscopy,,15700025,1160601687,06-04-2024,8.4,-8.4,681190.0,VL,Move Order Issue,1.0,6.2131,-6.2131,729.0,4529.34731
6020040013,XYLOCAINE-2% INJECTION -1'S,Medicine,Rayan Hospital,RAY_ENSCPY,RYN 11105-Endoscopy,,15700025,1160601687,06-04-2024,8.4,-25.2,681195.0,VL,Move Order Issue,3.0,6.2131,-18.63929,726.0,4510.70802
6020040013,XYLOCAINE-2% INJECTION -1'S,Medicine,Rayan Hospital,STAGE,Rayan Hospital Clinics,RAY_LDR,17538914,1160968118,07-04-2024,8.4,-504.0,681197.0,VL,Int Order Direct Ship,60.0,6.2131,-372.78579,666.0,4137.92224
6020040013,XYLOCAINE-2% INJECTION -1'S,Medicine,Rayan Hospital,STAGE,Rayan Hospital Clinics,RAY_CATHLB,17539118,1161081101,07-04-2024,8.4,-42.0,681197.0,VL,Int Order Direct Ship,5.0,6.2131,-31.06548,661.0,4106.85676
6020040013,XYLOCAINE-2% INJECTION -1'S,Medicine,Rayan Hospital,RAY_UROLGY,RYN 11225-Urology,,15707068,1161178950,07-04-2024,8.4,-8.4,681195.0,VL,Move Order Issue,1.0,6.2131,-6.2131,660.0,4100.64366
6020040013,XYLOCAINE-2% INJECTION -1'S,Medicine,Rayan Hospital,RYN_IP,,,,1161436282,08-04-2024,8.4,-8.4,681198.0,VL,Issue to Patient,1.0,6.2131,-6.2131,659.0,4094.43056
6020040013,XYLOCAINE-2% INJECTION -1'S,Medicine,Rayan Hospital,STAGE,Rayan Hospital Clinics,RAY_ER,17539393,1161720569,09-04-2024,8.4,-100.8,681197.0,VL,Int Order Direct Ship,12.0,6.2131,-74.55716,647.0,4019.8734
6020040013,XYLOCAINE-2% INJECTION -1'S,Medicine,Rayan Hospital,RYN_IP,,,,1162393955,13-04-2024,8.4,-8.4,681198.0,VL,Issue to Patient,1.0,6.2131,-6.2131,646.0,4013.66031
6020040013,XYLOCAINE-2% INJECTION -1'S,Medicine,Rayan Hospital,RAY_GENSUR,RYN 11227-General Surgery Clinic,,15708763,1162796739,14-04-2024,8.4,-134.4,681195.0,VL,Move Order Issue,16.0,6.2131,-99.40954,630.0,3914.25077
6020040013,XYLOCAINE-2% INJECTION -1'S,Medicine,Rayan Hospital,RAY_GENSUR,RYN 11227-General Surgery Clinic,,15708763,1162796739,14-04-2024,8.4,-319.2,681197.0,VL,Move Order Issue,38.0,6.2131,-236.09767,592.0,3678.1531
6020040013,XYLOCAINE-2% INJECTION -1'S,Medicine,Rayan Hospital,RYN_IP,,,,1163023057,14-04-2024,8.4,-8.4,681198.0,VL,Issue to Patient,1.0,6.2131,-6.2131,591.0,3671.94
6020040013,XYLOCAINE-2% INJECTION -1'S,Medicine,Rayan Hospital,STAGE,Rayan Hospital Clinics,RAY_OR,17539623,1163140770,15-04-2024,8.4,-84.0,681198.0,VL,Int Order Direct Ship,10.0,6.2131,-62.13096,581.0,3609.80904
6020040013,XYLOCAINE-2% INJECTION -1'S,Medicine,Rayan Hospital,RYN_IP,,,,1163352215,15-04-2024,8.4,-8.4,681198.0,VL,Issue to Patient,1.0,6.2131,-6.2131,580.0,3603.59594
6020040013,XYLOCAINE-2% INJECTION -1'S,Medicine,Rayan Hospital,RYN_IP,,,,1163437716,15-04-2024,8.4,-8.4,681198.0,VL,Issue to Patient,1.0,6.2131,-6.2131,579.0,3597.38285
6020040013,XYLOCAINE-2% INJECTION -1'S,Medicine,Rayan Hospital,RYN_IP,,,,1163685618,16-04-2024,8.4,-8.4,681198.0,VL,Issue to Patient,1.0,6.2131,-6.2131,578.0,3591.16975
6020040013,XYLOCAINE-2% INJECTION -1'S,Medicine,Rayan Hospital,STAGE,Rayan Hospital Clinics,RAY_TELMET,17542422,1164505463,17-04-2024,8.4,-8.4,681195.0,VL,Int Order Direct Ship,1.0,6.21596,-6.21596,597.0,3710.9255
6020040013,XYLOCAINE-2% INJECTION -1'S,Medicine,Rayan Hospital,RYN_IP,,,,1164509846,17-04-2024,8.4,-8.4,681195.0,VL,Issue to Patient,1.0,6.21596,-6.21596,596.0,3704.70955
6020040013,XYLOCAINE-2% INJECTION -1'S,Medicine,Rayan Hospital,RAY_OPTHA,RYN 11216-Ophthalmology,,15722939,1164664175,17-04-2024,8.4,-16.8,681197.0,VL,Move Order Issue,2.0,6.21596,-12.43191,594.0,3692.27764
6020040013,XYLOCAINE-2% INJECTION -1'S,Medicine,Rayan Hospital,RYN_IP,,,,1164781709,17-04-2024,8.4,-8.4,681198.0,VL,Issue to Patient,1.0,6.21596,-6.21596,593.0,3686.06168
6020040013,XYLOCAINE-2% INJECTION -1'S,Medicine,Rayan Hospital,RYN_IP,,,,1164808259,18-04-2024,8.4,-8.4,681198.0,VL,Issue to Patient,1.0,6.21596,-6.21596,592.0,3679.84572
6020040013,XYLOCAINE-2% INJECTION -1'S,Medicine,Rayan Hospital,RAY_IVF,RYN 11212-IVF,,15724481,1165047606,18-04-2024,8.4,-16.8,681195.0,VL,Move Order Issue,2.0,6.21596,-12.43191,590.0,3667.41381
6020040013,XYLOCAINE-2% INJECTION -1'S,Medicine,Rayan Hospital,RAY_IVF,RYN 11212-IVF,,15724481,1165047606,18-04-2024,8.4,-8.4,681197.0,VL,Move Order Issue,1.0,6.21596,-6.21596,589.0,3661.19786
6020040013,XYLOCAINE-2% INJECTION -1'S,Medicine,Rayan Hospital,RYN_IP,,,,1165225778,18-04-2024,8.4,-8.4,681198.0,VL,Issue to Patient,1.0,6.21596,-6.21596,588.0,3654.9819
6020040013,XYLOCAINE-2% INJECTION -1'S,Medicine,Rayan Hospital,RYN_IP,,,,1165374190,19-04-2024,8.4,-8.4,681198.0,VL,Issue to Patient,1.0,6.21596,-6.21596,587.0,3648.76595
6020040013,XYLOCAINE-2% INJECTION -1'S,Medicine,Rayan Hospital,RYN_IP,,,,1165636596,20-04-2024,8.4,-8.4,681198.0,VL,Issue to Patient,1.0,6.21596,-6.21596,586.0,3642.54999
6020040013,XYLOCAINE-2% INJECTION -1'S,Medicine,Rayan Hospital,RAY_ORPCLN,RYN 11217-Orthopedics,,15731523,1165980503,20-04-2024,8.4,-42.0,681195.0,VL,Move Order Issue,5.0,6.21596,-31.07978,581.0,3611.47021
6020040013,XYLOCAINE-2% INJECTION -1'S,Medicine,Rayan Hospital,RAY_ORPCLN,RYN 11217-Orthopedics,,15731523,1165980503,20-04-2024,8.4,-168.0,681197.0,VL,Move Order Issue,20.0,6.21596,-124.31911,561.0,3487.1511
6020040013,XYLOCAINE-2% INJECTION -1'S,Medicine,Rayan Hospital,RYN_IP,,,,1166051391,20-04-2024,8.4,-8.4,681198.0,VL,Issue to Patient,1.0,6.21596,-6.21596,560.0,3480.93514
6020040013,XYLOCAINE-2% INJECTION -1'S,Medicine,Rayan Hospital,STAGE,Rayan Hospital Clinics,RAY_LDR,17544998,1166386581,21-04-2024,8.4,-42.0,681198.0,VL,Int Order Direct Ship,5.0,6.21596,-31.07978,555.0,3449.85537
6020040013,XYLOCAINE-2% INJECTION -1'S,Medicine,Rayan Hospital,STAGE,Rayan Hospital Clinics,RAY_CCU,17544916,1166419272,21-04-2024,8.4,-33.6,681198.0,VL,Int Order Direct Ship,4.0,6.21596,-24.86382,551.0,3424.99154
6020040013,XYLOCAINE-2% INJECTION -1'S,Medicine,Rayan Hospital,STAGE,Rayan Hospital Clinics,RAY_CATHLB,17544798,1166498789,21-04-2024,8.4,-25.2,681195.0,VL,Int Order Direct Ship,3.0,6.21596,-18.64787,548.0,3406.34368
6020040013,XYLOCAINE-2% INJECTION -1'S,Medicine,Rayan Hospital,STAGE,Rayan Hospital Clinics,RAY_CATHLB,17544798,1166498791,21-04-2024,8.4,-42.0,681198.0,VL,Int Order Direct Ship,5.0,6.21596,-31.07978,543.0,3375.2639
6020040013,XYLOCAINE-2% INJECTION -1'S,Medicine,Rayan Hospital,STAGE,Rayan Hospital Clinics,RAY_OR,17545662,1166516856,21-04-2024,8.4,-252.0,681198.0,VL,Int Order Direct Ship,30.0,6.21596,-186.47867,513.0,3188.78523
6020040013,XYLOCAINE-2% INJECTION -1'S,Medicine,Rayan Hospital,RAY_OPTHA,RYN 11216-Ophthalmology,,15729172,1167044022,22-04-2024,8.4,-8.4,681198.0,VL,Move Order Issue,1.0,6.21596,-6.21596,512.0,3182.56927
6020040013,XYLOCAINE-2% INJECTION -1'S,Medicine,Rayan Hospital,RAY_DERMA,RYN 11204-Dermatology,,15738361,1167488048,23-04-2024,8.4,-50.4,681197.0,VL,Move Order Issue,6.0,6.21596,-37.29573,506.0,3145.27354
6020040013,XYLOCAINE-2% INJECTION -1'S,Medicine,Rayan Hospital,RYN_IP,,,,1167506184,23-04-2024,8.4,-8.4,681198.0,VL,Issue to Patient,1.0,6.21596,-6.21596,505.0,3139.05759
6020040013,XYLOCAINE-2% INJECTION -1'S,Medicine,Rayan Hospital,RYN_IP,,,,1167996493,24-04-2024,8.4,-8.4,681198.0,VL,Issue to Patient,1.0,6.21596,-6.21596,504.0,3132.84163
6020040013,XYLOCAINE-2% INJECTION -1'S,Medicine,Rayan Hospital,RAY_OPTHA,RYN 11216-Ophthalmology,,15741690,1168253353,24-04-2024,8.4,-8.4,681198.0,VL,Move Order Issue,1.0,6.21596,-6.21596,503.0,3126.62567
6020040013,XYLOCAINE-2% INJECTION -1'S,Medicine,Rayan Hospital,RYN_IP,,,,1168424319,24-04-2024,8.4,-8.4,681198.0,VL,Issue to Patient,1.0,6.21596,-6.21596,502.0,3120.40972
6020040013,XYLOCAINE-2% INJECTION -1'S,Medicine,Rayan Hospital,RYN_IP,,,,1168600723,25-04-2024,8.4,-8.4,681198.0,VL,Issue to Patient,1.0,6.21596,-6.21596,501.0,3114.19376
6020040013,XYLOCAINE-2% INJECTION -1'S,Medicine,Rayan Hospital,RAY_GENSUR,RYN 11227-General Surgery Clinic,,15740952,1168759656,25-04-2024,8.4,-294.0,681198.0,VL,Move Order Issue,35.0,6.21596,-217.55845,466.0,2896.63532
6020040013,XYLOCAINE-2% INJECTION -1'S,Medicine,Rayan Hospital,RYN_IP,,,,1168956762,25-04-2024,8.4,-8.4,681198.0,VL,Issue to Patient,1.0,6.21596,-6.21596,465.0,2890.41936
6020040013,XYLOCAINE-2% INJECTION -1'S,Medicine,Rayan Hospital,STAGE,Rayan Hospital Clinics,RAY_OR,17548820,1169457484,27-04-2024,8.4,-252.0,681198.0,VL,Int Order Direct Ship,30.0,6.21596,-186.47867,435.0,2703.94069
6020040013,XYLOCAINE-2% INJECTION -1'S,Medicine,Rayan Hospital,STAGE,Rayan Hospital Clinics,RAY_CATHLB,17548841,1169499911,27-04-2024,8.4,-67.2,681198.0,VL,Int Order Direct Ship,8.0,6.21596,-49.72764,427.0,2654.21305
6020040013,XYLOCAINE-2% INJECTION -1'S,Medicine,Rayan Hospital,RYN_IP,,,,1170754219,29-04-2024,8.4,-8.4,681198.0,VL,Issue to Patient,1.0,6.23167,-6.23167,526.0,3277.86053
6020040013,XYLOCAINE-2% INJECTION -1'S,Medicine,Rayan Hospital,RYN_IP,,,,1170828800,29-04-2024,8.4,-8.4,6811100.0,VL,Issue to Patient,1.0,6.23167,-6.23167,526.0,3277.86053
6020040013,XYLOCAINE-2% INJECTION -1'S,Medicine,Rayan Hospital,RAY_IVF,RYN 11212-IVF,,15760407,1171450491,30-04-2024,8.4,-25.2,6811100.0,VL,Move Order Issue,3.0,6.23167,-18.69502,523.0,3259.1655
6020040013,XYLOCAINE-2% INJECTION -1'S,Medicine,Rayan Hospital,STAGE,Rayan Hospital Clinics,RAY_LDR,17551737,1171925131,01-05-2024,8.4,-168.0,681198.0,VL,Int Order Direct Ship,20.0,6.23167,-124.63348,503.0,3134.53202
6020040013,XYLOCAINE-2% INJECTION -1'S,Medicine,Rayan Hospital,STAGE,Rayan Hospital Clinics,RAY_OR,17551327,1171959485,01-05-2024,8.4,-252.0,681198.0,VL,Int Order Direct Ship,30.0,6.23167,-186.95022,473.0,2947.5818
6020040013,XYLOCAINE-2% INJECTION -1'S,Medicine,Rayan Hospital,STAGE,Rayan Hospital Clinics,RAY_LDR,17551300,1172028327,01-05-2024,8.4,-84.0,681198.0,VL,Int Order Direct Ship,10.0,6.23167,-62.31674,463.0,2885.26506
6020040013,XYLOCAINE-2% INJECTION -1'S,Medicine,Rayan Hospital,RAY_GENSUR,RYN 11227-General Surgery Clinic,,15761426,1172564658,02-05-2024,8.4,-84.0,6811100.0,VL,Move Order Issue,10.0,6.23167,-62.31674,453.0,2822.94832
6020040013,XYLOCAINE-2% INJECTION -1'S,Medicine,Rayan Hospital,RAY_GENSUR,RYN 11227-General Surgery Clinic,,15761426,1172564658,02-05-2024,8.4,-42.0,681198.0,VL,Move Order Issue,5.0,6.23167,-31.15837,448.0,2791.78995
6020040013,XYLOCAINE-2% INJECTION -1'S,Medicine,Rayan Hospital,RYN_IP,,,,1172970644,03-05-2024,8.4,-8.4,681198.0,VL,Issue to Patient,1.0,6.23167,-6.23167,447.0,2785.55828
6020040013,XYLOCAINE-2% INJECTION -1'S,Medicine,Rayan Hospital,RYN_IP,,,,1173194328,04-05-2024,8.4,-8.4,681198.0,VL,Issue to Patient,1.0,6.23167,-6.23167,446.0,2779.3266
6020040013,XYLOCAINE-2% INJECTION -1'S,Medicine,Rayan Hospital,STAGE,Rayan Hospital Clinics,RAY_OR,17553683,1173309334,04-05-2024,8.4,-168.0,681198.0,VL,Int Order Direct Ship,20.0,6.23167,-124.63348,426.0,2654.69312
6020040013,XYLOCAINE-2% INJECTION -1'S,Medicine,Rayan Hospital,RAY_ORPCLN,RYN 11217-Orthopedics,,15762479,1173675666,04-05-2024,8.4,-84.0,681197.0,VL,Move Order Issue,10.0,6.23167,-62.31674,416.0,2592.37638
6020040013,XYLOCAINE-2% INJECTION -1'S,Medicine,Rayan Hospital,RAY_ORPCLN,RYN 11217-Orthopedics,,15762479,1173675666,04-05-2024,8.4,-168.0,681198.0,VL,Move Order Issue,20.0,6.23167,-124.63348,396.0,2467.7429
6020040013,XYLOCAINE-2% INJECTION -1'S,Medicine,Rayan Hospital,RAY_OPTHA,RYN 11216-Ophthalmology,,15776195,1174722142,06-05-2024,8.4,-8.4,6811100.0,VL,Move Order Issue,1.0,6.23167,-6.23167,395.0,2461.51123
6020040013,XYLOCAINE-2% INJECTION -1'S,Medicine,Rayan Hospital,STAGE,Rayan Hospital Clinics,RAY_LDR,17554522,1174730551,06-05-2024,8.4,-84.0,681198.0,VL,Int Order Direct Ship,10.0,6.23167,-62.31674,385.0,2399.19449
6020040013,XYLOCAINE-2% INJECTION -1'S,Medicine,Rayan Hospital,RYN_IP,,,,1174773997,06-05-2024,8.4,-8.4,681198.0,VL,Issue to Patient,1.0,6.23167,-6.23167,384.0,2392.96282
6020040013,XYLOCAINE-2% INJECTION -1'S,Medicine,Rayan Hospital,RAY_DERMA,RYN 11204-Dermatology,,15783885,1175757451,08-05-2024,8.4,-16.8,6811100.0,VL,Move Order Issue,2.0,6.23167,-12.46335,382.0,2380.49947
6020040013,XYLOCAINE-2% INJECTION -1'S,Medicine,Rayan Hospital,RAY_DERMA,RYN 11204-Dermatology,,15783885,1175757451,08-05-2024,8.4,-8.4,681197.0,VL,Move Order Issue,1.0,6.23167,-6.23167,381.0,2374.26779
6020040013,XYLOCAINE-2% INJECTION -1'S,Medicine,Rayan Hospital,RAY_DERMA,RYN 11204-Dermatology,,15783885,1175757451,08-05-2024,8.4,-50.4,681198.0,VL,Move Order Issue,6.0,6.23167,-37.39004,375.0,2336.87775
6020040013,XYLOCAINE-2% INJECTION -1'S,Medicine,Rayan Hospital,STAGE,Rayan Hospital Clinics,RAY_OR,17556199,1175776513,08-05-2024,8.4,-168.0,681198.0,VL,Int Order Direct Ship,20.0,6.23167,-124.63348,355.0,2212.24427
6020040013,XYLOCAINE-2% INJECTION -1'S,Medicine,Rayan Hospital,RAY_RDLOGY,RYN 13101-Radiology,,15783160,1175889619,08-05-2024,8.4,-16.8,681187.0,VL,Move Order Issue,2.0,6.23167,-12.46335,353.0,2199.78092
6020040013,XYLOCAINE-2% INJECTION -1'S,Medicine,Rayan Hospital,STAGE,Rayan Hospital Clinics,RAY_ER,17556210,1176343542,09-05-2024,8.4,-33.6,681198.0,VL,Int Order Direct Ship,4.0,6.23167,-24.9267,349.0,2174.85423
6020040013,XYLOCAINE-2% INJECTION -1'S,Medicine,Rayan Hospital,RAY_IVF,RYN 11212-IVF,,15780664,1176765186,09-05-2024,8.4,-16.8,6811100.0,VL,Move Order Issue,2.0,6.23167,-12.46335,347.0,2162.39088
6020040013,XYLOCAINE-2% INJECTION -1'S,Medicine,Rayan Hospital,STAGE,Rayan Hospital Clinics,RAY_OR,17574685,1177178890,11-05-2024,8.4,-168.0,681198.0,VL,Int Order Direct Ship,20.0,6.23167,-124.63348,327.0,2037.7574
6020040013,XYLOCAINE-2% INJECTION -1'S,Medicine,Rayan Hospital,RYN_IP,,,,1177330812,11-05-2024,8.4,-8.4,681198.0,VL,Issue to Patient,1.0,6.23167,-6.23167,326.0,2031.52572
6020040013,XYLOCAINE-2% INJECTION -1'S,Medicine,Rayan Hospital,RYN_IP,,,,1177574376,11-05-2024,8.4,-8.4,681198.0,VL,Issue to Patient,1.0,6.23901,-6.23901,365.0,2277.23838
6020040013,XYLOCAINE-2% INJECTION -1'S,Medicine,Rayan Hospital,STAGE,Rayan Hospital Clinics,RAY_LDR,17574671,1177738139,12-05-2024,8.4,-126.0,681198.0,VL,Int Order Direct Ship,15.0,6.23901,-93.58514,350.0,2183.65324
6020040013,XYLOCAINE-2% INJECTION -1'S,Medicine,Rayan Hospital,STAGE,Rayan Hospital Clinics,RAY_ER,17573737,1177814778,12-05-2024,8.4,-16.8,681198.0,VL,Int Order Direct Ship,2.0,6.23901,-12.47802,348.0,2171.17522
6020040013,XYLOCAINE-2% INJECTION -1'S,Medicine,Rayan Hospital,RYN_IP,,,,1178389091,13-05-2024,8.4,-8.4,6811100.0,VL,Issue to Patient,1.0,6.23901,-6.23901,347.0,2164.93621
6020040013,XYLOCAINE-2% INJECTION -1'S,Medicine,Rayan Hospital,RAY_ENT,RYN 11205-E.N.T. (Otolaryngology),,15790428,1178495921,13-05-2024,8.4,-16.8,681197.0,VL,Move Order Issue,2.0,6.23901,-12.47802,345.0,2152.45819
6020040013,XYLOCAINE-2% INJECTION -1'S,Medicine,Rayan Hospital,RAY_ENT,RYN 11205-E.N.T. (Otolaryngology),,15790428,1178495921,13-05-2024,8.4,-8.4,681195.0,VL,Move Order Issue,1.0,6.23901,-6.23901,344.0,2146.21918
6020040013,XYLOCAINE-2% INJECTION -1'S,Medicine,Rayan Hospital,RAY_OPTHA,RYN 11216-Ophthalmology,,15828910,1178746389,13-05-2024,8.4,-8.4,6811100.0,VL,Move Order Issue,1.0,6.23901,-6.23901,343.0,2139.98017
6020040013,XYLOCAINE-2% INJECTION -1'S,Medicine,Rayan Hospital,RYN_IP,,,,1178762914,13-05-2024,8.4,-8.4,681198.0,VL,Issue to Patient,1.0,6.23901,-6.23901,342.0,2133.74116
6020040013,XYLOCAINE-2% INJECTION -1'S,Medicine,Rayan Hospital,RYN_IP,,,,1179066892,14-05-2024,8.4,-8.4,681198.0,VL,Issue to Patient,1.0,6.23901,-6.23901,341.0,2127.50215
6020040013,XYLOCAINE-2% INJECTION -1'S,Medicine,Rayan Hospital,RYN_IP,,,,1179455684,14-05-2024,8.4,-8.4,681198.0,VL,Issue to Patient,1.0,6.23901,-6.23901,340.0,2121.26314
6020040013,XYLOCAINE-2% INJECTION -1'S,Medicine,Rayan Hospital,STAGE,Rayan Hospital Clinics,RAY_OR,17605911,1179737964,15-05-2024,8.4,-252.0,681198.0,VL,Int Order Direct Ship,30.0,6.23901,-187.17028,310.0,1934.09287
6020040013,XYLOCAINE-2% INJECTION -1'S,Medicine,Rayan Hospital,STAGE,Rayan Hospital Clinics,RAY_CATHLB,17592138,1179784553,15-05-2024,8.4,-67.2,681198.0,VL,Int Order Direct Ship,8.0,6.23901,-49.91207,302.0,1884.18079
6020040013,XYLOCAINE-2% INJECTION -1'S,Medicine,Rayan Hospital,RAY_IVF,RYN 11212-IVF,,15839525,1179805211,15-05-2024,8.4,-25.2,6811100.0,VL,Move Order Issue,3.0,6.23901,-18.71703,299.0,1865.46377
6020040013,XYLOCAINE-2% INJECTION -1'S,Medicine,Rayan Hospital,STAGE,Rayan Hospital Clinics,RAY_LDR,17605917,1179845142,15-05-2024,8.4,-168.0,681198.0,VL,Int Order Direct Ship,20.0,6.23901,-124.78018,279.0,1740.68358
6020040013,XYLOCAINE-2% INJECTION -1'S,Medicine,Rayan Hospital,RYN_IP,,,,1180307769,16-05-2024,8.4,-8.4,681198.0,VL,Issue to Patient,1.0,6.23901,-6.23901,278.0,1734.44457
6020040013,XYLOCAINE-2% INJECTION -1'S,Medicine,Rayan Hospital,RYN_IP,,,,1180873309,17-05-2024,8.4,-8.4,681198.0,VL,Issue to Patient,1.0,6.23901,-6.23901,277.0,1728.20556
6020040013,XYLOCAINE-2% INJECTION -1'S,Medicine,Rayan Hospital,RYN_IP,,,,1180956502,17-05-2024,8.4,-8.4,681198.0,VL,Issue to Patient,1.0,6.23901,-6.23901,276.0,1721.96655
6020040013,XYLOCAINE-2% INJECTION -1'S,Medicine,Rayan Hospital,RYN_IP,,,,1181188486,18-05-2024,8.4,-8.4,681198.0,VL,Issue to Patient,1.0,6.23901,-6.23901,275.0,1715.72754
6020040013,XYLOCAINE-2% INJECTION -1'S,Medicine,Rayan Hospital,STAGE,Rayan Hospital Clinics,RAY_OR,17618139,1181240377,18-05-2024,8.4,-252.0,681198.0,VL,Int Order Direct Ship,30.0,6.23901,-187.17028,245.0,1528.55727
6020040013,XYLOCAINE-2% INJECTION -1'S,Medicine,Rayan Hospital,RAY_UROLGY,RYN 11225-Urology,,15828175,1182142295,19-05-2024,8.4,-8.4,681195.0,VL,Move Order Issue,1.0,6.25634,-6.25634,344.0,2152.18008
6020040013,XYLOCAINE-2% INJECTION -1'S,Medicine,Rayan Hospital,STAGE,Rayan Hospital Clinics,RAY_ER,17618265,1182489262,20-05-2024,8.4,-33.6,681198.0,VL,Int Order Direct Ship,4.0,6.25634,-25.02535,340.0,2127.15473
6020040013,XYLOCAINE-2% INJECTION -1'S,Medicine,Rayan Hospital,RAY_OBGY1F,RYN 11215-OB&Gyne,,15864971,1182908230,20-05-2024,8.4,-33.6,6811100.0,VL,Move Order Issue,4.0,6.25634,-25.02535,336.0,2102.12938
6020040013,XYLOCAINE-2% INJECTION -1'S,Medicine,Rayan Hospital,RAY_OBGY1F,RYN 11215-OB&Gyne,,15864971,1182908230,20-05-2024,8.4,-25.2,681194.0,VL,Move Order Issue,3.0,6.25634,-18.76901,333.0,2083.36037
6020040013,XYLOCAINE-2% INJECTION -1'S,Medicine,Rayan Hospital,RAY_OBGY1F,RYN 11215-OB&Gyne,,15864971,1182908230,20-05-2024,8.4,-260.4,681195.0,VL,Move Order Issue,31.0,6.25634,-193.94646,302.0,1889.41391
6020040013,XYLOCAINE-2% INJECTION -1'S,Medicine,Rayan Hospital,RAY_OBGY1F,RYN 11215-OB&Gyne,,15864971,1182908230,20-05-2024,8.4,-67.2,681197.0,VL,Move Order Issue,8.0,6.25634,-50.0507,294.0,1839.36321
6020040013,XYLOCAINE-2% INJECTION -1'S,Medicine,Rayan Hospital,RAY_OBGY1F,RYN 11215-OB&Gyne,,15864971,1182908230,20-05-2024,8.4,-33.6,681198.0,VL,Move Order Issue,4.0,6.25634,-25.02535,290.0,1814.33786
6020040013,XYLOCAINE-2% INJECTION -1'S,Medicine,Rayan Hospital,RAY_OBGY2F,RYN 11215-OB&Gyne,,15866040,1182945838,20-05-2024,8.4,-58.8,681194.0,VL,Move Order Issue,7.0,6.25634,-43.79436,283.0,1770.5435
6020040013,XYLOCAINE-2% INJECTION -1'S,Medicine,Rayan Hospital,RAY_OBGY2F,RYN 11215-OB&Gyne,,15866040,1182945838,20-05-2024,8.4,-25.2,681195.0,VL,Move Order Issue,3.0,6.25634,-18.76901,280.0,1751.77448
6020040013,XYLOCAINE-2% INJECTION -1'S,Medicine,Rayan Hospital,RYN_IP,,,,1183179320,21-05-2024,8.4,-8.4,681199.0,VL,Issue to Patient,1.0,6.25634,-6.25634,279.0,1745.51815
6020040013,XYLOCAINE-2% INJECTION -1'S,Medicine,Rayan Hospital,RAY_ENT,RYN 11205-E.N.T. (Otolaryngology),,10720063,1183264758,21-05-2024,8.4,-8.4,681190.0,VL,Move Order Issue,1.0,6.25634,-6.25634,278.0,1739.26181
6020040013,XYLOCAINE-2% INJECTION -1'S,Medicine,Rayan Hospital,RYN_IP,,,,1183733837,22-05-2024,8.4,-8.4,681199.0,VL,Issue to Patient,1.0,6.25634,-6.25634,277.0,1733.00547
6020040013,XYLOCAINE-2% INJECTION -1'S,Medicine,Rayan Hospital,RAY_DERMA,RYN 11204-Dermatology,,15871007,1183888634,22-05-2024,8.4,-92.4,6811100.0,VL,Move Order Issue,11.0,6.25634,-68.81971,266.0,1664.18576
6020040013,XYLOCAINE-2% INJECTION -1'S,Medicine,Rayan Hospital,STAGE,Rayan Hospital Clinics,RAY_ER,17625935,1183967408,22-05-2024,8.4,-25.2,681198.0,VL,Int Order Direct Ship,3.0,6.25634,-18.76901,263.0,1645.41675
6020040013,XYLOCAINE-2% INJECTION -1'S,Medicine,Rayan Hospital,RAY_OPTHA,RYN 11216-Ophthalmology,,15871222,1184120567,22-05-2024,8.4,-8.4,6811100.0,VL,Move Order Issue,1.0,6.25634,-6.25634,262.0,1639.16041
6020040013,XYLOCAINE-2% INJECTION -1'S,Medicine,Rayan Hospital,RYN_IP,,,,1184210411,22-05-2024,8.4,-8.4,681199.0,VL,Issue to Patient,1.0,6.25634,-6.25634,261.0,1632.90407
6020040013,XYLOCAINE-2% INJECTION -1'S,Medicine,Rayan Hospital,RYN_IP,,,,1184272276,22-05-2024,8.4,-8.4,681199.0,VL,Issue to Patient,1.0,6.25634,-6.25634,260.0,1626.64773
6020040013,XYLOCAINE-2% INJECTION -1'S,Medicine,Rayan Hospital,RYN_IP,,,,1184274150,22-05-2024,8.4,-8.4,681199.0,VL,Issue to Patient,1.0,6.25634,-6.25634,259.0,1620.3914
6020040013,XYLOCAINE-2% INJECTION -1'S,Medicine,Rayan Hospital,RYN_IP,,,,1184388761,23-05-2024,8.4,-8.4,681199.0,VL,Issue to Patient,1.0,6.25634,-6.25634,258.0,1614.13506
6020040013,XYLOCAINE-2% INJECTION -1'S,Medicine,Rayan Hospital,RYN_IP,,,,1184579309,23-05-2024,8.4,-8.4,681199.0,VL,Issue to Patient,1.0,6.25634,-6.25634,257.0,1607.87872
6020040013,XYLOCAINE-2% INJECTION -1'S,Medicine,Rayan Hospital,STAGE,Rayan Hospital Clinics,RAY_OR,17626274,1184614436,23-05-2024,8.4,-100.8,681198.0,VL,Int Order Direct Ship,12.0,6.25634,-75.07605,245.0,1532.80267
6020040013,XYLOCAINE-2% INJECTION -1'S,Medicine,Rayan Hospital,STAGE,Rayan Hospital Clinics,RAY_OR,17626274,1184614438,23-05-2024,8.4,-67.2,681199.0,VL,Int Order Direct Ship,8.0,6.25634,-50.0507,237.0,1482.75197
6020040013,XYLOCAINE-2% INJECTION -1'S,Medicine,Rayan Hospital,RYN_IP,,,,1184888361,23-05-2024,8.4,-8.4,681199.0,VL,Issue to Patient,1.0,6.2888,-6.2888,976.0,6137.86863
6020040013,XYLOCAINE-2% INJECTION -1'S,Medicine,Rayan Hospital,STAGE,Rayan Hospital Clinics,RAY_OR,17632498,1185263235,25-05-2024,8.4,-168.0,681199.0,VL,Int Order Direct Ship,20.0,6.2888,-125.776,956.0,6012.09263
6020040013,XYLOCAINE-2% INJECTION -1'S,Medicine,Rayan Hospital,STAGE,Rayan Hospital Clinics,RAY_LDR,17632486,1185471352,25-05-2024,8.4,-168.0,681199.0,VL,Int Order Direct Ship,20.0,6.2888,-125.776,936.0,5886.31664
6020040013,XYLOCAINE-2% INJECTION -1'S,Medicine,Rayan Hospital,STAGE,Rayan Hospital Clinics,RAY_CATHLB,17632679,1185526827,25-05-2024,8.4,-84.0,681199.0,VL,Int Order Direct Ship,10.0,6.2888,-62.888,926.0,5823.42864
6020040013,XYLOCAINE-2% INJECTION -1'S,Medicine,Rayan Hospital,RYN_IP,,,,1185587685,25-05-2024,8.4,-8.4,681199.0,VL,Issue to Patient,1.0,6.2888,-6.2888,925.0,5817.13984
6020040013,XYLOCAINE-2% INJECTION -1'S,Medicine,Rayan Hospital,RAY_OPTHA,RYN 11216-Ophthalmology,,15885180,1185622809,25-05-2024,8.4,-8.4,681198.0,VL,Move Order Issue,1.0,6.2888,-6.2888,924.0,5810.85104
6020040013,XYLOCAINE-2% INJECTION -1'S,Medicine,Rayan Hospital,RYN_IP,,,,1185642674,25-05-2024,8.4,-8.4,681199.0,VL,Issue to Patient,1.0,6.2888,-6.2888,923.0,5804.56224
6020040013,XYLOCAINE-2% INJECTION -1'S,Medicine,Rayan Hospital,STAGE,Rayan Hospital Clinics,RAY_ER,17632501,1185795318,26-05-2024,8.4,-42.0,681199.0,VL,Int Order Direct Ship,5.0,6.2888,-31.444,918.0,5773.11824
6020040013,XYLOCAINE-2% INJECTION -1'S,Medicine,Rayan Hospital,RAY_GENSUR,RYN 11227-General Surgery Clinic,,15879476,1185867775,26-05-2024,8.4,-336.0,6811100.0,VL,Move Order Issue,40.0,6.2888,-251.55199,878.0,5521.56625
6020040013,XYLOCAINE-2% INJECTION -1'S,Medicine,Rayan Hospital,RAY_GENSUR,RYN 11227-General Surgery Clinic,,15879476,1185867775,26-05-2024,8.4,-126.0,681198.0,VL,Move Order Issue,15.0,6.2888,-94.332,863.0,5427.23425
6020040013,XYLOCAINE-2% INJECTION -1'S,Medicine,Rayan Hospital,RYN_IP,Rayan Main Pharmacy,RYN_MP,RAY29006,1185903141,26-05-2024,8.4,-8.4,681199.0,VL,Intransit Shipment,1.0,6.2888,-6.2888,862.0,5420.94545
6020040013,XYLOCAINE-2% INJECTION -1'S,Medicine,Rayan Hospital,RAY_ENSCPY,RYN 11105-Endoscopy,,15887480,1186009761,26-05-2024,8.4,-8.4,681195.0,VL,Move Order Issue,1.0,6.2888,-6.2888,861.0,5414.65665
6020040013,XYLOCAINE-2% INJECTION -1'S,Medicine,Rayan Hospital,RAY_ENSCPY,RYN 11105-Endoscopy,,15887480,1186009761,26-05-2024,8.4,-8.4,681197.0,VL,Move Order Issue,1.0,6.2888,-6.2888,860.0,5408.36785
6020040013,XYLOCAINE-2% INJECTION -1'S,Medicine,Rayan Hospital,RAY_OBGY1F,RYN 11215-OB&Gyne,,15888114,1186172629,26-05-2024,8.4,-16.8,6811100.0,VL,Move Order Issue,2.0,6.2888,-12.5776,858.0,5395.79025
6020040013,XYLOCAINE-2% INJECTION -1'S,Medicine,Rayan Hospital,RAY_OBGY1F,RYN 11215-OB&Gyne,,15888986,1186214724,26-05-2024,8.4,-16.8,6811100.0,VL,Move Order Issue,2.0,6.2888,-12.5776,856.0,5383.21265
6020040013,XYLOCAINE-2% INJECTION -1'S,Medicine,Rayan Hospital,RYN_IP,,,,1186398226,27-05-2024,8.4,-8.4,681199.0,VL,Issue to Patient,1.0,6.2888,-6.2888,855.0,5376.92385
6020040013,XYLOCAINE-2% INJECTION -1'S,Medicine,Rayan Hospital,RAY_OBGY2F,RYN 11215-OB&Gyne,,15891150,1186619497,27-05-2024,8.4,-25.2,681198.0,VL,Move Order Issue,3.0,6.2888,-18.8664,852.0,5358.05745
6020040013,XYLOCAINE-2% INJECTION -1'S,Medicine,Rayan Hospital,RAY_ENT,RYN 11205-E.N.T. (Otolaryngology),,15892253,1186640532,27-05-2024,8.4,-8.4,6811100.0,VL,Move Order Issue,1.0,6.2888,-6.2888,851.0,5351.76865
6020040013,XYLOCAINE-2% INJECTION -1'S,Medicine,Rayan Hospital,RAY_OPTHA,RYN 11216-Ophthalmology,,15893544,1186809487,27-05-2024,8.4,-8.4,681199.0,VL,Move Order Issue,1.0,6.2888,-6.2888,850.0,5345.47985
6020040013,XYLOCAINE-2% INJECTION -1'S,Medicine,Rayan Hospital,RYN_IP,,,,1187025769,27-05-2024,8.4,-16.8,681199.0,VL,Issue to Patient,2.0,6.2888,-12.5776,848.0,5332.90225
6020040013,XYLOCAINE-2% INJECTION -1'S,Medicine,Rayan Hospital,RAY_ENT,RYN 11205-E.N.T. (Otolaryngology),,15895458,1187209694,28-05-2024,8.4,-8.4,6811100.0,VL,Move Order Issue,1.0,6.2888,-6.2888,847.0,5326.61345
6020040013,XYLOCAINE-2% INJECTION -1'S,Medicine,Rayan Hospital,RAY_ORPCLN,RYN 11217-Orthopedics,,15891585,1187290271,28-05-2024,8.4,-352.8,6811100.0,VL,Move Order Issue,42.0,6.2888,-264.12959,805.0,5062.48386
6020040013,XYLOCAINE-2% INJECTION -1'S,Medicine,Rayan Hospital,RAY_ORPCLN,RYN 11217-Orthopedics,,15891585,1187290271,28-05-2024,8.4,-84.0,681198.0,VL,Move Order Issue,10.0,6.2888,-62.888,795.0,4999.59586
6020040013,XYLOCAINE-2% INJECTION -1'S,Medicine,Rayan Hospital,RAY_ORPCLN,RYN 11217-Orthopedics,,15891585,1187290271,28-05-2024,8.4,-84.0,681199.0,VL,Move Order Issue,10.0,6.2888,-62.888,785.0,4936.70786
6020040013,XYLOCAINE-2% INJECTION -1'S,Medicine,Rayan Hospital,RAY_IVF,RYN 11212-IVF,,15897206,1187434647,28-05-2024,8.4,-16.8,681197.0,VL,Move Order Issue,2.0,6.2888,-12.5776,783.0,4924.13026
6020040013,XYLOCAINE-2% INJECTION -1'S,Medicine,Rayan Hospital,RAY_IVF,RYN 11212-IVF,,15897206,1187434647,28-05-2024,8.4,-8.4,681199.0,VL,Move Order Issue,1.0,6.2888,-6.2888,782.0,4917.84146
6020040013,XYLOCAINE-2% INJECTION -1'S,Medicine,Rayan Hospital,RAY_NEURO,RYN 11214-Neurology,,15895890,1187511325,28-05-2024,8.4,-16.8,681195.0,VL,Move Order Issue,2.0,6.2888,-12.5776,780.0,4905.26387
6020040013,XYLOCAINE-2% INJECTION -1'S,Medicine,Rayan Hospital,RAY_NEURO,RYN 11214-Neurology,,15895890,1187511325,28-05-2024,8.4,-8.4,681199.0,VL,Move Order Issue,1.0,6.2888,-6.2888,779.0,4898.97507
6020040013,XYLOCAINE-2% INJECTION -1'S,Medicine,Rayan Hospital,RAY_UROLGY,RYN 11225-Urology,,15897549,1187578126,28-05-2024,8.4,-8.4,681197.0,VL,Move Order Issue,1.0,6.2888,-6.2888,778.0,4892.68627
6020040013,XYLOCAINE-2% INJECTION -1'S,Medicine,Rayan Hospital,RYN_IP,,,,1187721687,29-05-2024,8.4,-8.4,681199.0,VL,Issue to Patient,1.0,6.2888,-6.2888,777.0,4886.39747
6020040013,XYLOCAINE-2% INJECTION -1'S,Medicine,Rayan Hospital,RAY_ENT,,,,1187805467,29-05-2024,8.4,-8.4,681199.0,VL,Physical Inv Adjust,1.0,6.2888,-6.2888,776.0,4880.10867
6020040013,XYLOCAINE-2% INJECTION -1'S,Medicine,Rayan Hospital,RAY_IVF,,,,1187835514,29-05-2024,8.4,-25.2,681199.0,VL,Physical Inv Adjust,3.0,6.2888,-18.8664,774.0,4867.53107
6020040013,XYLOCAINE-2% INJECTION -1'S,Medicine,Rayan Hospital,RYN_IP,,,,1187848585,29-05-2024,8.4,-8.4,681199.0,VL,Issue to Patient,1.0,6.2888,-6.2888,776.0,4880.10867
6020040013,XYLOCAINE-2% INJECTION -1'S,Medicine,Rayan Hospital,STAGE,Rayan Hospital Clinics,RAY_OR,17633993,1187849982,29-05-2024,8.4,-168.0,681199.0,VL,Int Order Direct Ship,20.0,6.2888,-125.776,756.0,4754.33267
6020040013,XYLOCAINE-2% INJECTION -1'S,Medicine,Rayan Hospital,RAY_UROLGY,,,,1187886190,29-05-2024,8.4,-8.4,681197.0,VL,Physical Inv Adjust,1.0,6.2888,-6.2888,755.0,4748.04387
6020040013,XYLOCAINE-2% INJECTION -1'S,Medicine,Rayan Hospital,STAGE,Rayan Hospital Clinics,RAY_LDR,17633991,1187895404,29-05-2024,8.4,-84.0,681199.0,VL,Int Order Direct Ship,10.0,6.2888,-62.888,746.0,4691.44467
6020040013,XYLOCAINE-2% INJECTION -1'S,Medicine,Rayan Hospital,RAY_DERMA,RYN 11204-Dermatology,,15900153,1187961734,29-05-2024,8.4,-33.6,681198.0,VL,Move Order Issue,4.0,6.2888,-25.1552,742.0,4666.28947
6020040013,XYLOCAINE-2% INJECTION -1'S,Medicine,Rayan Hospital,RAY_DERMA,RYN 11204-Dermatology,,15900153,1187961734,29-05-2024,8.4,-33.6,681199.0,VL,Move Order Issue,4.0,6.2888,-25.1552,738.0,4641.13427
6020040013,XYLOCAINE-2% INJECTION -1'S,Medicine,Rayan Hospital,RAY_GENSUR,RYN 11227-General Surgery Clinic,,15900141,1187979198,29-05-2024,8.4,-210.0,681199.0,VL,Move Order Issue,25.0,6.2888,-157.22,713.0,4483.91428
6020040013,XYLOCAINE-2% INJECTION -1'S,Medicine,Rayan Hospital,RAY_DERMA,,,,1188526667,30-05-2024,8.4,-25.2,681199.0,VL,Physical Inv Adjust,3.0,6.2888,-18.8664,711.0,4471.33668
6020040013,XYLOCAINE-2% INJECTION -1'S,Medicine,Rayan Hospital,RYN_IP,,,,1188656571,30-05-2024,8.4,-8.4,681199.0,VL,Issue to Patient,1.0,6.2888,-6.2888,713.0,4483.91428
6020040013,XYLOCAINE-2% INJECTION -1'S,Medicine,Rayan Hospital,RAY_OBGY1F,,,,1188674327,30-05-2024,8.4,-25.2,681199.0,VL,Physical Inv Adjust,3.0,6.2888,-18.8664,710.0,4465.04788
6020040013,XYLOCAINE-2% INJECTION -1'S,Medicine,Rayan Hospital,RYN_IP,,,,1188829012,30-05-2024,8.4,-8.4,681199.0,VL,Issue to Patient,1.0,6.2888,-6.2888,711.0,4471.33668
6020040013,XYLOCAINE-2% INJECTION -1'S,Medicine,Rayan Hospital,RYN_IP,,,,1188964128,31-05-2024,8.4,-8.4,681199.0,VL,Issue to Patient,1.0,6.2888,-6.2888,710.0,4465.04788
6020040013,XYLOCAINE-2% INJECTION -1'S,Medicine,Rayan Hospital,RYN_IP,,,,1189007017,31-05-2024,8.4,-8.4,681199.0,VL,Issue to Patient,1.0,6.2888,-6.2888,709.0,4458.75908
6020040013,XYLOCAINE-2% INJECTION -1'S,Medicine,Rayan Hospital,RYN_IP,,,,1189035961,31-05-2024,8.4,-67.2,681199.0,VL,Issue to Patient,8.0,6.2888,-50.3104,701.0,4408.44868
6020040013,XYLOCAINE-2% INJECTION -1'S,Medicine,Rayan Hospital,RAY_RDLOGY,,,,1189069750,31-05-2024,8.4,-50.4,681198.0,VL,Physical Inv Adjust,6.0,6.2888,-37.7328,695.0,4370.71588
6020040013,XYLOCAINE-2% INJECTION -1'S,Medicine,Rayan Hospital,RYN_IP,,,,1189202690,01-06-2024,8.4,-8.4,681199.0,VL,Issue to Patient,1.0,6.2888,-6.2888,725.0,4559.37987
6020040013,XYLOCAINE-2% INJECTION -1'S,Medicine,Rayan Hospital,STAGE,Rayan Hospital Clinics,RAY_OR,17636057,1189301059,01-06-2024,8.4,-252.0,681199.0,VL,Int Order Direct Ship,30.0,6.2888,-188.66399,695.0,4370.71588
6020040013,XYLOCAINE-2% INJECTION -1'S,Medicine,Rayan Hospital,STAGE,Rayan Hospital Clinics,RAY_ER,17641568,1189917413,02-06-2024,8.4,-25.2,681199.0,VL,Int Order Direct Ship,3.0,6.2888,-18.8664,692.0,4351.84948
6020040013,XYLOCAINE-2% INJECTION -1'S,Medicine,Rayan Hospital,RYN_IP,,,,1190853645,03-06-2024,8.4,-8.4,681199.0,VL,Issue to Patient,1.0,6.2888,-6.2888,691.0,4345.56068
6020040013,XYLOCAINE-2% INJECTION -1'S,Medicine,Rayan Hospital,RYN_IP,,,,1191135022,03-06-2024,8.4,-8.4,6811101.0,VL,Issue to Patient,1.0,6.2888,-6.2888,690.0,4339.27188
6020040013,XYLOCAINE-2% INJECTION -1'S,Medicine,Rayan Hospital,STAGE,Rayan Hospital Clinics,RAY_CATHLB,17644698,1191324876,04-06-2024,8.4,-42.0,681199.0,VL,Int Order Direct Ship,5.0,6.2888,-31.444,685.0,4307.82788
6020040013,XYLOCAINE-2% INJECTION -1'S,Medicine,Rayan Hospital,RYN_IP,,,,1191609730,04-06-2024,8.4,-8.4,681199.0,VL,Issue to Patient,1.0,6.2888,-6.2888,684.0,4301.53908
6020040013,XYLOCAINE-2% INJECTION -1'S,Medicine,Rayan Hospital,STAGE,Rayan Hospital Clinics,RAY_LDR,17642249,1191985529,05-06-2024,8.4,-235.2,681199.0,VL,Int Order Direct Ship,28.0,6.2888,-176.0864,656.0,4125.45269
6020040013,XYLOCAINE-2% INJECTION -1'S,Medicine,Rayan Hospital,STAGE,Rayan Hospital Clinics,RAY_OR,17645349,1192013618,05-06-2024,8.4,-168.0,681199.0,VL,Int Order Direct Ship,20.0,6.2888,-125.776,636.0,3999.67669
6020040013,XYLOCAINE-2% INJECTION -1'S,Medicine,Rayan Hospital,RYN_IP,,,,1192709303,06-06-2024,8.4,-8.4,681199.0,VL,Issue to Patient,1.0,6.2888,-6.2888,635.0,3993.38789
6020040013,XYLOCAINE-2% INJECTION -1'S,Medicine,Rayan Hospital,RYN_IP,,,,1192950305,06-06-2024,8.4,-8.4,681199.0,VL,Issue to Patient,1.0,6.2888,-6.2888,634.0,3987.09909
6020040013,XYLOCAINE-2% INJECTION -1'S,Medicine,Rayan Hospital,RYN_IP,,,,1193134482,07-06-2024,8.4,-8.4,6811101.0,VL,Issue to Patient,1.0,6.2888,-6.2888,633.0,3980.81029
6020040013,XYLOCAINE-2% INJECTION -1'S,Medicine,Rayan Hospital,RYN_IP,,,,1193289599,07-06-2024,8.4,-8.4,681199.0,VL,Issue to Patient,1.0,6.2888,-6.2888,632.0,3974.52149
6020040013,XYLOCAINE-2% INJECTION -1'S,Medicine,Rayan Hospital,RAY_IVF,RYN 11212-IVF,,15937009,1193453509,08-06-2024,8.4,-8.4,681197.0,VL,Move Order Issue,1.0,6.2888,-6.2888,631.0,3968.23269
6020040013,XYLOCAINE-2% INJECTION -1'S,Medicine,Rayan Hospital,STAGE,Rayan Hospital Clinics,RAY_LDR,17645337,1193869450,08-06-2024,8.4,-168.0,681199.0,VL,Int Order Direct Ship,20.0,6.2888,-125.776,611.0,3842.45669
6020040013,XYLOCAINE-2% INJECTION -1'S,Medicine,Rayan Hospital,RYN_IP,,,,1194479491,09-06-2024,8.4,-8.4,681199.0,VL,Issue to Patient,1.0,6.2888,-6.2888,610.0,3836.16789
6020040013,XYLOCAINE-2% INJECTION -1'S,Medicine,Rayan Hospital,RYN_IP,,,,1194688787,10-06-2024,8.4,-8.4,681199.0,VL,Issue to Patient,1.0,6.2888,-6.2888,610.0,3836.16789
6020040013,XYLOCAINE-2% INJECTION -1'S,Medicine,Rayan Hospital,STAGE,Rayan Hospital Clinics,RAY_LDR,17654207,1194844804,10-06-2024,8.4,-84.0,681199.0,VL,Int Order Direct Ship,10.0,6.2888,-62.888,601.0,3779.5687
6020040013,XYLOCAINE-2% INJECTION -1'S,Medicine,Rayan Hospital,STAGE,Rayan Hospital Clinics,RAY_ER,17654651,1194928525,10-06-2024,8.4,-25.2,681199.0,VL,Int Order Direct Ship,3.0,6.2888,-18.8664,598.0,3760.7023
6020040013,XYLOCAINE-2% INJECTION -1'S,Medicine,Rayan Hospital,RAY_OPTHA,RYN 11216-Ophthalmology,,15951311,1194978624,10-06-2024,8.4,-8.4,681199.0,VL,Move Order Issue,1.0,6.2888,-6.2888,597.0,3754.4135
6020040013,XYLOCAINE-2% INJECTION -1'S,Medicine,Rayan Hospital,RYN_IP,,,,1195327753,11-06-2024,8.4,-8.4,681199.0,VL,Issue to Patient,1.0,6.2888,-6.2888,596.0,3748.1247
6020040013,XYLOCAINE-2% INJECTION -1'S,Medicine,Rayan Hospital,STAGE,Rayan Hospital Clinics,RAY_LDR,17655755,1195448908,11-06-2024,8.4,-672.0,681199.0,VL,Int Order Direct Ship,80.0,6.2888,-503.10399,516.0,3245.02071
6020040013,XYLOCAINE-2% INJECTION -1'S,Medicine,Rayan Hospital,STAGE,Rayan Hospital Clinics,RAY_OR,17655837,1195461351,11-06-2024,8.4,-504.0,681199.0,VL,Int Order Direct Ship,60.0,6.2888,-377.32799,456.0,2867.69272
6020040013,XYLOCAINE-2% INJECTION -1'S,Medicine,Rayan Hospital,STAGE,Rayan Hospital Clinics,RAY_OR,17655795,1195462670,11-06-2024,8.4,-84.0,681199.0,VL,Int Order Direct Ship,10.0,6.2888,-62.888,446.0,2804.80472
6020040013,XYLOCAINE-2% INJECTION -1'S,Medicine,Rayan Hospital,RAY_DERMA,RYN 11204-Dermatology,,15959855,1195834361,11-06-2024,8.4,-25.2,681194.0,VL,Move Order Issue,3.0,6.2888,-18.8664,443.0,2785.93832
6020040013,XYLOCAINE-2% INJECTION -1'S,Medicine,Rayan Hospital,RAY_DERMA,RYN 11204-Dermatology,,15959855,1195834361,11-06-2024,8.4,-50.4,681199.0,VL,Move Order Issue,6.0,6.2888,-37.7328,437.0,2748.20552
6020040013,XYLOCAINE-2% INJECTION -1'S,Medicine,Rayan Hospital,RYN_IP,,,,1195958775,11-06-2024,8.4,-8.4,681199.0,VL,Issue to Patient,1.0,6.2888,-6.2888,436.0,2741.91672
6020040013,XYLOCAINE-2% INJECTION -1'S,Medicine,Rayan Hospital,RAY_IVF,RYN 11212-IVF,,15959870,1196146931,12-06-2024,8.4,-16.8,681197.0,VL,Move Order Issue,2.0,6.2888,-12.5776,434.0,2729.33913
6020040013,XYLOCAINE-2% INJECTION -1'S,Medicine,Rayan Hospital,RAY_IVF,RYN 11212-IVF,,15959870,1196146931,12-06-2024,8.4,-8.4,681199.0,VL,Move Order Issue,1.0,6.2888,-6.2888,433.0,2723.05033
6020040013,XYLOCAINE-2% INJECTION -1'S,Medicine,Rayan Hospital,RAY_GENSUR,RYN 11227-General Surgery Clinic,,15951172,1196189600,12-06-2024,8.4,-84.0,681199.0,VL,Move Order Issue,10.0,6.2888,-62.888,423.0,2660.16233
6020040013,XYLOCAINE-2% INJECTION -1'S,Medicine,Rayan Hospital,RYN_IP,,,,1196437042,12-06-2024,8.4,-8.4,681199.0,VL,Issue to Patient,1.0,6.2888,-6.2888,422.0,2653.87353
6020040013,XYLOCAINE-2% INJECTION -1'S,Medicine,Rayan Hospital,RYN_IP,,,,1196651141,13-06-2024,8.4,-8.4,681199.0,VL,Issue to Patient,1.0,6.2888,-6.2888,422.0,2653.87353
6020040013,XYLOCAINE-2% INJECTION -1'S,Medicine,Rayan Hospital,RYN_IP,,,,1198015054,18-06-2024,8.4,-8.4,681199.0,VL,Issue to Patient,1.0,6.2888,-6.2888,421.0,2647.58473
6020040013,XYLOCAINE-2% INJECTION -1'S,Medicine,Rayan Hospital,RYN_IP,,,,1198015059,18-06-2024,8.4,-8.4,681199.0,VL,Issue to Patient,1.0,6.2888,-6.2888,420.0,2641.29593
6020040013,XYLOCAINE-2% INJECTION -1'S,Medicine,Rayan Hospital,RAY_OPTHA,RYN 11216-Ophthalmology,,15981563,1198323124,19-06-2024,8.4,-8.4,6811101.0,VL,Move Order Issue,1.0,6.2888,-6.2888,419.0,2635.00713
6020040013,XYLOCAINE-2% INJECTION -1'S,Medicine,Rayan Hospital,RYN_IP,Rayan Main Pharmacy,RYN_MP,RAY29210,1198690583,20-06-2024,8.4,-8.4,681199.0,VL,Intransit Shipment,1.0,6.2888,-6.2888,418.0,2628.71833
6020040013,XYLOCAINE-2% INJECTION -1'S,Medicine,Rayan Hospital,RYN_IP,,,,1199038284,20-06-2024,8.4,-8.4,6811101.0,VL,Issue to Patient,1.0,6.2888,-6.2888,417.0,2622.42953
6020040013,XYLOCAINE-2% INJECTION -1'S,Medicine,Rayan Hospital,RYN_IP,,,,1199333092,21-06-2024,8.4,-8.4,6811101.0,VL,Issue to Patient,1.0,6.2888,-6.2888,416.0,2616.14073
6020040013,XYLOCAINE-2% INJECTION -1'S,Medicine,Rayan Hospital,RYN_IP,,,,1199368478,21-06-2024,8.4,-8.4,6811101.0,VL,Issue to Patient,1.0,6.2888,-6.2888,415.0,2609.85193
6020040013,XYLOCAINE-2% INJECTION -1'S,Medicine,Rayan Hospital,RYN_IP,,,,1199376520,21-06-2024,8.4,-8.4,6811101.0,VL,Issue to Patient,1.0,6.2888,-6.2888,414.0,2603.56313
6020040013,XYLOCAINE-2% INJECTION -1'S,Medicine,Rayan Hospital,STAGE,Rayan Hospital Clinics,RAY_CATHLB,17665491,1199535941,22-06-2024,8.4,-84.0,681199.0,VL,Int Order Direct Ship,10.0,6.2888,-62.888,405.0,2546.96393
6020040013,XYLOCAINE-2% INJECTION -1'S,Medicine,Rayan Hospital,STAGE,Rayan Hospital Clinics,RAY_ER,17663387,1200045825,23-06-2024,8.4,-25.2,681199.0,VL,Int Order Direct Ship,3.0,6.2888,-18.8664,402.0,2528.09753
6020040013,XYLOCAINE-2% INJECTION -1'S,Medicine,Rayan Hospital,STAGE,Rayan Hospital Clinics,RAY_ER,17663213,1200046848,23-06-2024,8.4,-16.8,681199.0,VL,Int Order Direct Ship,2.0,6.2888,-12.5776,400.0,2515.51993
6020040013,XYLOCAINE-2% INJECTION -1'S,Medicine,Rayan Hospital,STAGE,Rayan Hospital Clinics,RAY_ER,17666855,1200067898,23-06-2024,8.4,-25.2,681199.0,VL,Int Order Direct Ship,3.0,6.2888,-18.8664,397.0,2496.65353
6020040013,XYLOCAINE-2% INJECTION -1'S,Medicine,Rayan Hospital,RYN_IP,,,,1200693134,24-06-2024,8.4,-8.4,6811102.0,VL,Issue to Patient,1.0,6.29191,-6.29191,556.0,3498.29956
6020040013,XYLOCAINE-2% INJECTION -1'S,Medicine,Rayan Hospital,RYN_IP,,,,1201202276,25-06-2024,8.4,-8.4,6811102.0,VL,Issue to Patient,1.0,6.29191,-6.29191,555.0,3492.00766
6020040013,XYLOCAINE-2% INJECTION -1'S,Medicine,Rayan Hospital,RAY_OPTHA,RYN 11216-Ophthalmology,,16007262,1201867903,26-06-2024,8.4,-8.4,681199.0,VL,Move Order Issue,1.0,6.29191,-6.29191,554.0,3485.71575
6020040013,XYLOCAINE-2% INJECTION -1'S,Medicine,Rayan Hospital,RAY_UROLGY,RYN 11225-Urology,,16004738,1201922791,26-06-2024,8.4,-8.4,6811100.0,VL,Move Order Issue,1.0,6.29191,-6.29191,553.0,3479.42384
6020040013,XYLOCAINE-2% INJECTION -1'S,Medicine,Rayan Hospital,RYN_IP,,,,1202868156,28-06-2024,8.4,-8.4,6811102.0,VL,Issue to Patient,1.0,6.29191,-6.29191,552.0,3473.13194
6020040013,XYLOCAINE-2% INJECTION -1'S,Medicine,Rayan Hospital,RYN_IP,,,,1202952004,28-06-2024,8.4,-8.4,6811102.0,VL,Issue to Patient,1.0,6.29191,-6.29191,551.0,3466.84003
6020040013,XYLOCAINE-2% INJECTION -1'S,Medicine,Rayan Hospital,RYN_IP,,,,1203025624,28-06-2024,8.4,-8.4,6811102.0,VL,Issue to Patient,1.0,6.29191,-6.29191,550.0,3460.54813
6020040013,XYLOCAINE-2% INJECTION -1'S,Medicine,Rayan Hospital,STAGE,Rayan Hospital Clinics,RAY_CATHLB,17681771,1204012645,30-06-2024,8.4,-67.2,681199.0,VL,Int Order Direct Ship,8.0,6.29191,-50.33525,542.0,3410.21288
