Item Code,Description,Item Category,Oraganization,Sub Inventory,To Location,To Subinventory,Document Number,Transaction ID,Transaction DATE,SellingÂ  Price,Value of Selling Price,Lot Number,UOM,Transaction Type,Transaction Quantity,Transaction Cost,Transaction Value,Balance Quantity,Balance Value
6040060003,JJ BABY OIL GEL BLOSSOM - 200ML,Cosmetic,Rayan ER Pharmacy,RYN_ERP,,,,1112994358.0,04-01-2024,33.44,-33.44,509727.0,PCS,Issue to Patient,1.0,25.08,-25.08,10.0,250.8
6040060003,JJ BABY OIL GEL BLOSSOM - 200ML,Cosmetic,Rayan ER Pharmacy,RYN_ERP,,,,1116877170.0,12-01-2024,33.44,-33.44,509727.0,PCS,Issue to Patient,1.0,25.08,-25.08,9.0,225.72
6040060003,JJ BABY OIL GEL BLOSSOM - 200ML,Cosmetic,Rayan ER Pharmacy,RYN_ERP,,,,1121014550.0,20-01-2024,33.44,-33.44,509727.0,PCS,Issue to Patient,1.0,25.08,-25.08,8.0,200.64
6040060003,JJ BABY OIL GEL BLOSSOM - 200ML,Cosmetic,Rayan ER Pharmacy,RYN_ERP,,,,1124366893.0,26-01-2024,33.44,-33.44,509727.0,PCS,Issue to Patient,1.0,25.08,-25.08,7.0,175.56
6040060003,JJ BABY OIL GEL BLOSSOM - 200ML,Cosmetic,Rayan ER Pharmacy,RYN_ERP,,,,1133865489.0,12-02-2024,33.44,-33.44,509727.0,PCS,Issue to Patient,1.0,25.08,-25.08,6.0,150.48
6040060003,JJ BABY OIL GEL BLOSSOM - 200ML,Cosmetic,Rayan ER Pharmacy,RYN_ERP,,,,1148253329.0,11-03-2024,33.44,-33.44,509727.0,PCS,Issue to Patient,1.0,25.08,-25.08,5.0,125.4
6040060003,JJ BABY OIL GEL BLOSSOM - 200ML,Cosmetic,Rayan ER Pharmacy,RYN_ERP,,,,1160303982.0,05-04-2024,33.44,-33.44,509727.0,PCS,Issue to Patient,1.0,25.08,-25.08,4.0,100.32
6040060003,JJ BABY OIL GEL BLOSSOM - 200ML,Cosmetic,Rayan ER Pharmacy,RYN_ERP,,,,1178817134.0,13-05-2024,33.44,-33.44,509727.0,PCS,Issue to Patient,1.0,25.08,-25.08,3.0,75.24
6040060003,JJ BABY OIL GEL BLOSSOM - 200ML,Cosmetic,Rayan ER Pharmacy,RYN_ERP,,,,1189061282.0,31-05-2024,33.44,-33.44,509727.0,PCS,Issue to Patient,1.0,25.08,-25.08,2.0,50.16
