Item Code,Description,Item Category,Oraganization,Sub Inventory,To Location,To Subinventory,Document Number,Transaction ID,Transaction DATE,SellingÂ  Price,Value of Selling Price,Lot Number,UOM,Transaction Type,Transaction Quantity,Transaction Cost,Transaction Value,Balance Quantity,Balance Value
6310040016,DUODERM 20X20 CM DRES (GRANULFEX),Cosmetic,Rayan Hospital,RYN_IP,,,,1111298204,01-01-2024,57.14,-114.28,461929.0,PCS,Issue to Patient,2.0,43.81009,-87.62018,27.0,1182.87248
6310040016,DUODERM 20X20 CM DRES (GRANULFEX),Cosmetic,Rayan Hospital,RYN_IP,,,,1111367160,02-01-2024,57.14,-114.28,461929.0,PCS,Issue to Patient,2.0,43.81009,-87.62018,25.0,1095.2523
6310040016,DUODERM 20X20 CM DRES (GRANULFEX),Cosmetic,Rayan Hospital,RYN_IP,,,,1111372574,02-01-2024,57.14,-114.28,461929.0,PCS,Issue to Patient,2.0,43.81009,-87.62018,23.0,1007.63211
6310040016,DUODERM 20X20 CM DRES (GRANULFEX),Cosmetic,Rayan Hospital,RYN_IP,,,,1113008331,04-01-2024,57.14,-57.14,461928.0,PCS,Issue to Patient,1.0,43.81884,-43.81884,62.0,2716.76783
6310040016,DUODERM 20X20 CM DRES (GRANULFEX),Cosmetic,Rayan Hospital,RYN_IP,,,,1113050226,05-01-2024,57.14,-57.14,461928.0,PCS,Issue to Patient,1.0,43.81884,-43.81884,61.0,2672.949
6310040016,DUODERM 20X20 CM DRES (GRANULFEX),Cosmetic,Rayan Hospital,RYN_IP,,,,1113840544,07-01-2024,57.14,-57.14,461928.0,PCS,Issue to Patient,1.0,43.81884,-43.81884,60.0,2629.13016
6310040016,DUODERM 20X20 CM DRES (GRANULFEX),Cosmetic,Rayan Hospital,RYN_IP,,,,1113841377,07-01-2024,57.14,-57.14,461928.0,PCS,Issue to Patient,1.0,43.81884,-43.81884,59.0,2585.31132
6310040016,DUODERM 20X20 CM DRES (GRANULFEX),Cosmetic,Rayan Hospital,RYN_IP,,,,1113841387,07-01-2024,57.14,-57.14,461928.0,PCS,Issue to Patient,1.0,43.81884,-43.81884,58.0,2541.49249
6310040016,DUODERM 20X20 CM DRES (GRANULFEX),Cosmetic,Rayan Hospital,RYN_IP,,,,1113843404,07-01-2024,57.14,-57.14,461928.0,PCS,Issue to Patient,1.0,43.81884,-43.81884,57.0,2497.67365
6310040016,DUODERM 20X20 CM DRES (GRANULFEX),Cosmetic,Rayan Hospital,RYN_IP,,,,1113858454,07-01-2024,57.14,-57.14,461928.0,PCS,Issue to Patient,1.0,43.81884,-43.81884,56.0,2453.85482
6310040016,DUODERM 20X20 CM DRES (GRANULFEX),Cosmetic,Rayan Hospital,RYN_IP,,,,1114584558,08-01-2024,57.14,-57.14,461928.0,PCS,Issue to Patient,1.0,43.81884,-43.81884,55.0,2410.03598
6310040016,DUODERM 20X20 CM DRES (GRANULFEX),Cosmetic,Rayan Hospital,RYN_IP,,,,1115542360,09-01-2024,57.14,-57.14,461928.0,PCS,Issue to Patient,1.0,43.81884,-43.81884,54.0,2366.21714
6310040016,DUODERM 20X20 CM DRES (GRANULFEX),Cosmetic,Rayan Hospital,RYN_IP,,,,1115570526,10-01-2024,57.14,-57.14,461929.0,PCS,Issue to Patient,1.0,43.81884,-43.81884,53.0,2322.39831
6310040016,DUODERM 20X20 CM DRES (GRANULFEX),Cosmetic,Rayan Hospital,RYN_IP,,,,1115603331,10-01-2024,57.14,-57.14,461929.0,PCS,Issue to Patient,1.0,43.81884,-43.81884,52.0,2278.57947
6310040016,DUODERM 20X20 CM DRES (GRANULFEX),Cosmetic,Rayan Hospital,RYN_IP,,,,1116670660,12-01-2024,57.14,-57.14,461928.0,PCS,Issue to Patient,1.0,43.81884,-43.81884,51.0,2234.76064
6310040016,DUODERM 20X20 CM DRES (GRANULFEX),Cosmetic,Rayan Hospital,RYN_IP,,,,1116683428,12-01-2024,57.14,-57.14,461929.0,PCS,Issue to Patient,1.0,43.81884,-43.81884,50.0,2190.9418
6310040016,DUODERM 20X20 CM DRES (GRANULFEX),Cosmetic,Rayan Hospital,RYN_IP,,,,1116686271,12-01-2024,57.14,-57.14,461928.0,PCS,Issue to Patient,1.0,43.81884,-43.81884,49.0,2147.12296
6310040016,DUODERM 20X20 CM DRES (GRANULFEX),Cosmetic,Rayan Hospital,RYN_IP,,,,1116722819,12-01-2024,57.14,-57.14,461929.0,PCS,Issue to Patient,1.0,43.81884,-43.81884,48.0,2103.30413
6310040016,DUODERM 20X20 CM DRES (GRANULFEX),Cosmetic,Rayan Hospital,RYN_IP,,,,1116722829,12-01-2024,57.14,-57.14,461929.0,PCS,Issue to Patient,1.0,43.81884,-43.81884,47.0,2059.48529
6310040016,DUODERM 20X20 CM DRES (GRANULFEX),Cosmetic,Rayan Hospital,RYN_IP,,,,1116722839,12-01-2024,57.14,-57.14,461928.0,PCS,Issue to Patient,1.0,43.81884,-43.81884,46.0,2015.66646
6310040016,DUODERM 20X20 CM DRES (GRANULFEX),Cosmetic,Rayan Hospital,RYN_IP,,,,1116723049,12-01-2024,57.14,-57.14,461928.0,PCS,Issue to Patient,1.0,43.81884,-43.81884,45.0,1971.84762
6310040016,DUODERM 20X20 CM DRES (GRANULFEX),Cosmetic,Rayan Hospital,RYN_IP,,,,1116730185,12-01-2024,57.14,-57.14,461929.0,PCS,Issue to Patient,1.0,43.81884,-43.81884,44.0,1928.02878
6310040016,DUODERM 20X20 CM DRES (GRANULFEX),Cosmetic,Rayan Hospital,RYN_IP,,,,1116731270,12-01-2024,57.14,-57.14,461930.0,PCS,Issue to Patient,1.0,43.81884,-43.81884,43.0,1884.20995
6310040016,DUODERM 20X20 CM DRES (GRANULFEX),Cosmetic,Rayan Hospital,RYN_IP,,,,1116732554,12-01-2024,57.14,-57.14,461928.0,PCS,Issue to Patient,1.0,43.81884,-43.81884,42.0,1840.39111
6310040016,DUODERM 20X20 CM DRES (GRANULFEX),Cosmetic,Rayan Hospital,RYN_IP,,,,1116904125,13-01-2024,57.14,-57.14,461929.0,PCS,Issue to Patient,1.0,43.81884,-43.81884,41.0,1796.57228
6310040016,DUODERM 20X20 CM DRES (GRANULFEX),Cosmetic,Rayan Hospital,RYN_IP,,,,1116917653,13-01-2024,57.14,-57.14,461929.0,PCS,Issue to Patient,1.0,43.81884,-43.81884,40.0,1752.75344
6310040016,DUODERM 20X20 CM DRES (GRANULFEX),Cosmetic,Rayan Hospital,RYN_IP,,,,1116917688,13-01-2024,57.14,-57.14,461928.0,PCS,Issue to Patient,1.0,43.81884,-43.81884,39.0,1708.9346
6310040016,DUODERM 20X20 CM DRES (GRANULFEX),Cosmetic,Rayan Hospital,RYN_IP,,,,1117502960,14-01-2024,57.14,-57.14,461930.0,PCS,Issue to Patient,1.0,43.82132,-43.82132,76.0,3330.42011
6310040016,DUODERM 20X20 CM DRES (GRANULFEX),Cosmetic,Rayan Hospital,RYN_IP,,,,1117503372,14-01-2024,57.14,-57.14,461930.0,PCS,Issue to Patient,1.0,43.82132,-43.82132,75.0,3286.5988
6310040016,DUODERM 20X20 CM DRES (GRANULFEX),Cosmetic,Rayan Hospital,RYN_IP,,,,1117838260,14-01-2024,57.14,-57.14,461930.0,PCS,Issue to Patient,1.0,43.82132,-43.82132,74.0,3242.77748
6310040016,DUODERM 20X20 CM DRES (GRANULFEX),Cosmetic,Rayan Hospital,STAGE,Rayan Hospital Clinics,RAY_RT,17456455,1118354937,15-01-2024,57.14,-571.4,461929.0,PCS,Int Order Direct Ship,10.0,43.82132,-438.21317,64.0,2804.56431
6310040016,DUODERM 20X20 CM DRES (GRANULFEX),Cosmetic,Rayan Hospital,RYN_IP,,,,1118722351,16-01-2024,57.14,-171.42,461930.0,PCS,Issue to Patient,3.0,43.82132,-131.46395,61.0,2673.10036
6310040016,DUODERM 20X20 CM DRES (GRANULFEX),Cosmetic,Rayan Hospital,RYN_IP,,,,1118722381,16-01-2024,57.14,-228.56,461930.0,PCS,Issue to Patient,4.0,43.82132,-175.28527,57.0,2497.81509
6310040016,DUODERM 20X20 CM DRES (GRANULFEX),Cosmetic,Rayan Hospital,RYN_IP,,,,1118732319,16-01-2024,57.14,-285.7,461930.0,PCS,Issue to Patient,5.0,43.82132,-219.10659,52.0,2278.7085
6310040016,DUODERM 20X20 CM DRES (GRANULFEX),Cosmetic,Rayan Hospital,RYN_IP,,,,1119954462,17-01-2024,57.14,-57.14,461930.0,PCS,Issue to Patient,1.0,43.82132,-43.82132,51.0,2234.88718
6310040016,DUODERM 20X20 CM DRES (GRANULFEX),Cosmetic,Rayan Hospital,RYN_IP,,,,1119964287,17-01-2024,57.14,-57.14,461930.0,PCS,Issue to Patient,1.0,43.82132,-43.82132,50.0,2191.06586
6310040016,DUODERM 20X20 CM DRES (GRANULFEX),Cosmetic,Rayan Hospital,RYN_IP,,,,1119983837,18-01-2024,57.14,-57.14,461930.0,PCS,Issue to Patient,1.0,43.82132,-43.82132,49.0,2147.24455
6310040016,DUODERM 20X20 CM DRES (GRANULFEX),Cosmetic,Rayan Hospital,RYN_IP,,,,1120027476,18-01-2024,57.14,-57.14,461930.0,PCS,Issue to Patient,1.0,43.82132,-43.82132,48.0,2103.42323
6310040016,DUODERM 20X20 CM DRES (GRANULFEX),Cosmetic,Rayan Hospital,RYN_IP,,,,1120510715,18-01-2024,57.14,-57.14,461930.0,PCS,Issue to Patient,1.0,43.82132,-43.82132,47.0,2059.60191
6310040016,DUODERM 20X20 CM DRES (GRANULFEX),Cosmetic,Rayan Hospital,RYN_IP,,,,1120773662,19-01-2024,57.14,-57.14,461930.0,PCS,Issue to Patient,1.0,43.82132,-43.82132,46.0,2015.7806
6310040016,DUODERM 20X20 CM DRES (GRANULFEX),Cosmetic,Rayan Hospital,RYN_IP,,,,1121293957,20-01-2024,57.14,-57.14,461928.0,PCS,Issue to Patient,1.0,43.82132,-43.82132,45.0,1971.95928
6310040016,DUODERM 20X20 CM DRES (GRANULFEX),Cosmetic,Rayan Hospital,RYN_IP,,,,1122260482,22-01-2024,57.14,-171.42,461930.0,PCS,Issue to Patient,3.0,43.82132,-131.46395,42.0,1840.49533
6310040016,DUODERM 20X20 CM DRES (GRANULFEX),Cosmetic,Rayan Hospital,RYN_IP,,,,1122794972,23-01-2024,57.14,-57.14,461930.0,PCS,Issue to Patient,1.0,43.82132,-43.82132,41.0,1796.67401
6310040016,DUODERM 20X20 CM DRES (GRANULFEX),Cosmetic,Rayan Hospital,RYN_IP,,,,1124275761,25-01-2024,57.14,-57.14,461930.0,PCS,Issue to Patient,1.0,43.82132,-43.82132,40.0,1752.85269
6310040016,DUODERM 20X20 CM DRES (GRANULFEX),Cosmetic,Rayan Hospital,RYN_IP,,,,1124279653,26-01-2024,57.14,-57.14,461930.0,PCS,Issue to Patient,1.0,43.82132,-43.82132,39.0,1709.03137
6310040016,DUODERM 20X20 CM DRES (GRANULFEX),Cosmetic,Rayan Hospital,RYN_IP,,,,1124341057,26-01-2024,57.14,-57.14,461930.0,PCS,Issue to Patient,1.0,43.82132,-43.82132,38.0,1665.21006
6310040016,DUODERM 20X20 CM DRES (GRANULFEX),Cosmetic,Rayan Hospital,RYN_IP,,,,1124362788,26-01-2024,57.14,-57.14,461930.0,PCS,Issue to Patient,1.0,43.82132,-43.82132,37.0,1621.38874
6310040016,DUODERM 20X20 CM DRES (GRANULFEX),Cosmetic,Rayan Hospital,RYN_IP,,,,1125152287,28-01-2024,57.14,-171.42,461928.0,PCS,Issue to Patient,3.0,43.82132,-131.46395,34.0,1489.92479
6310040016,DUODERM 20X20 CM DRES (GRANULFEX),Cosmetic,Rayan Hospital,RYN_IP,,,,1125189734,28-01-2024,57.14,-114.28,461928.0,PCS,Issue to Patient,2.0,43.82132,-87.64263,32.0,1402.28215
6310040016,DUODERM 20X20 CM DRES (GRANULFEX),Cosmetic,Rayan Hospital,RYN_IP,,,,1125189764,28-01-2024,57.14,-114.28,461929.0,PCS,Issue to Patient,2.0,43.82132,-87.64263,30.0,1314.63952
6310040016,DUODERM 20X20 CM DRES (GRANULFEX),Cosmetic,Rayan Hospital,RYN_IP,,,,1125609788,28-01-2024,57.14,-57.14,461930.0,PCS,Issue to Patient,1.0,43.82132,-43.82132,29.0,1270.8182
6310040016,DUODERM 20X20 CM DRES (GRANULFEX),Cosmetic,Rayan Hospital,RYN_IP,,,,1125976901,29-01-2024,57.14,-57.14,461930.0,PCS,Issue to Patient,1.0,43.82132,-43.82132,28.0,1226.99688
6310040016,DUODERM 20X20 CM DRES (GRANULFEX),Cosmetic,Rayan Hospital,RYN_IP,,,,1126353226,30-01-2024,57.14,-57.14,461929.0,PCS,Issue to Patient,1.0,43.82132,-43.82132,27.0,1183.17557
6310040016,DUODERM 20X20 CM DRES (GRANULFEX),Cosmetic,Rayan Hospital,RYN_IP,,,,1126353321,30-01-2024,57.14,-57.14,461929.0,PCS,Issue to Patient,1.0,43.82132,-43.82132,26.0,1139.35425
6310040016,DUODERM 20X20 CM DRES (GRANULFEX),Cosmetic,Rayan Hospital,RYN_IP,,,,1126371256,30-01-2024,57.14,-114.28,461928.0,PCS,Issue to Patient,2.0,43.82132,-87.64263,24.0,1051.71162
6310040016,DUODERM 20X20 CM DRES (GRANULFEX),Cosmetic,Rayan Hospital,RYN_IP,,,,1126723541,30-01-2024,57.14,-57.14,461930.0,PCS,Issue to Patient,1.0,43.82132,-43.82132,23.0,1007.8903
6310040016,DUODERM 20X20 CM DRES (GRANULFEX),Cosmetic,Rayan Hospital,RYN_IP,,,,1126982959,31-01-2024,57.14,-57.14,461928.0,PCS,Issue to Patient,1.0,43.82132,-43.82132,22.0,964.06898
6310040016,DUODERM 20X20 CM DRES (GRANULFEX),Cosmetic,Rayan Hospital,RYN_IP,,,,1126982969,31-01-2024,57.14,-57.14,461929.0,PCS,Issue to Patient,1.0,43.82132,-43.82132,21.0,920.24766
6310040016,DUODERM 20X20 CM DRES (GRANULFEX),Cosmetic,Rayan Hospital,RYN_IP,,,,1126985899,31-01-2024,57.14,-57.14,461928.0,PCS,Issue to Patient,1.0,43.82132,-43.82132,20.0,876.42635
6310040016,DUODERM 20X20 CM DRES (GRANULFEX),Cosmetic,Rayan Hospital,RYN_IP,,,,1127489890,31-01-2024,57.14,-57.14,461930.0,PCS,Issue to Patient,1.0,43.82132,-43.82132,19.0,832.60503
6310040016,DUODERM 20X20 CM DRES (GRANULFEX),Cosmetic,Rayan Hospital,RYN_IP,,,,1128037676,02-02-2024,57.14,-57.14,461930.0,PCS,Issue to Patient,1.0,43.82132,-43.82132,18.0,788.78371
6310040016,DUODERM 20X20 CM DRES (GRANULFEX),Cosmetic,Rayan Hospital,RYN_IP,,,,1128061137,02-02-2024,57.14,-57.14,461930.0,PCS,Issue to Patient,1.0,43.82132,-43.82132,17.0,744.96239
6310040016,DUODERM 20X20 CM DRES (GRANULFEX),Cosmetic,Rayan Hospital,RYN_IP,,,,1128102612,02-02-2024,57.14,-57.14,461930.0,PCS,Issue to Patient,1.0,43.82132,-43.82132,16.0,701.14108
6310040016,DUODERM 20X20 CM DRES (GRANULFEX),Cosmetic,Rayan Hospital,RYN_IP,,,,1128164146,02-02-2024,57.14,-114.28,461930.0,PCS,Issue to Patient,2.0,43.82132,-87.64263,14.0,613.49844
6310040016,DUODERM 20X20 CM DRES (GRANULFEX),Cosmetic,Rayan Hospital,RYN_IP,,,,1128268071,02-02-2024,57.14,-57.14,461930.0,PCS,Issue to Patient,1.0,43.82132,-43.82132,13.0,569.67712
6310040016,DUODERM 20X20 CM DRES (GRANULFEX),Cosmetic,Rayan Hospital,RYN_IP,,,,1128309351,03-02-2024,57.14,-57.14,461928.0,PCS,Issue to Patient,1.0,43.82132,-43.82132,12.0,525.85581
6310040016,DUODERM 20X20 CM DRES (GRANULFEX),Cosmetic,Rayan Hospital,RYN_IP,,,,1128310329,03-02-2024,57.14,-57.14,461930.0,PCS,Issue to Patient,1.0,43.82132,-43.82132,11.0,482.03449
6310040016,DUODERM 20X20 CM DRES (GRANULFEX),Cosmetic,Rayan Hospital,RYN_IP,,,,1128312583,03-02-2024,57.14,-57.14,461930.0,PCS,Issue to Patient,1.0,43.82132,-43.82132,10.0,438.21317
6310040016,DUODERM 20X20 CM DRES (GRANULFEX),Cosmetic,Rayan Hospital,RYN_IP,,,,1128317557,03-02-2024,57.14,-57.14,461930.0,PCS,Issue to Patient,1.0,43.82132,-43.82132,9.0,394.39186
6310040016,DUODERM 20X20 CM DRES (GRANULFEX),Cosmetic,Rayan Hospital,RYN_IP,,,,1128319245,03-02-2024,57.14,-57.14,461928.0,PCS,Issue to Patient,1.0,43.82132,-43.82132,8.0,350.57054
6310040016,DUODERM 20X20 CM DRES (GRANULFEX),Cosmetic,Rayan Hospital,RYN_IP,,,,1128799425,03-02-2024,57.14,-57.14,461930.0,PCS,Issue to Patient,1.0,43.82132,-43.82132,7.0,306.74922
6310040016,DUODERM 20X20 CM DRES (GRANULFEX),Cosmetic,Rayan Hospital,RYN_IP,,,,1128826535,03-02-2024,57.14,-57.14,461928.0,PCS,Issue to Patient,1.0,43.82132,-43.82132,6.0,262.9279
6310040016,DUODERM 20X20 CM DRES (GRANULFEX),Cosmetic,Rayan Hospital,RYN_IP,,,,1129495377,05-02-2024,57.14,-57.14,461930.0,PCS,Issue to Patient,1.0,43.82132,-43.82132,5.0,219.10659
6310040016,DUODERM 20X20 CM DRES (GRANULFEX),Cosmetic,Rayan Hospital,RYN_IP,,,,1129705021,05-02-2024,57.14,-57.14,461930.0,PCS,Issue to Patient,1.0,43.82132,-43.82132,4.0,175.28527
6310040016,DUODERM 20X20 CM DRES (GRANULFEX),Cosmetic,Rayan Hospital,RYN_IP,,,,1130144583,06-02-2024,57.14,-57.14,461928.0,PCS,Issue to Patient,1.0,43.82132,-43.82132,3.0,131.46395
6310040016,DUODERM 20X20 CM DRES (GRANULFEX),Cosmetic,Rayan Hospital,RYN_IP,,,,1130145623,06-02-2024,57.14,-57.14,461928.0,PCS,Issue to Patient,1.0,43.82132,-43.82132,2.0,87.64263
6310040016,DUODERM 20X20 CM DRES (GRANULFEX),Cosmetic,Rayan Hospital,RYN_IP,,,,1130145800,06-02-2024,57.14,-57.14,461930.0,PCS,Issue to Patient,1.0,43.82132,-43.82132,1.0,43.82132
6310040016,DUODERM 20X20 CM DRES (GRANULFEX),Cosmetic,Rayan Hospital,RYN_IP,,,,1130146102,06-02-2024,57.14,-57.14,461928.0,PCS,Issue to Patient,1.0,43.82132,-43.82132,0.0,0.0
6310040016,DUODERM 20X20 CM DRES (GRANULFEX),Cosmetic,Rayan Hospital,RYN_IP,,,,1130693133,06-02-2024,57.14,-57.14,461928.0,PCS,Issue to Patient,1.0,43.82132,-43.82132,0.0,0.0
6310040016,DUODERM 20X20 CM DRES (GRANULFEX),Cosmetic,Rayan Hospital,RYN_IP,,,,1138249164,21-02-2024,57.14,-57.14,461931.0,PCS,Issue to Patient,1.0,42.0,-42.0,49.0,2058.0
6310040016,DUODERM 20X20 CM DRES (GRANULFEX),Cosmetic,Rayan Hospital,RYN_IP,,,,1139244167,23-02-2024,57.14,-57.14,461931.0,PCS,Issue to Patient,1.0,42.0,-42.0,48.0,2016.0
6310040016,DUODERM 20X20 CM DRES (GRANULFEX),Cosmetic,Rayan Hospital,RYN_IP,,,,1139994569,24-02-2024,57.14,-57.14,461931.0,PCS,Issue to Patient,1.0,42.0,-42.0,47.0,1974.0
6310040016,DUODERM 20X20 CM DRES (GRANULFEX),Cosmetic,Rayan Hospital,RYN_IP,,,,1139998155,24-02-2024,57.14,-57.14,461931.0,PCS,Issue to Patient,1.0,42.0,-42.0,46.0,1932.0
6310040016,DUODERM 20X20 CM DRES (GRANULFEX),Cosmetic,Rayan Hospital,RYN_IP,,,,1140143539,25-02-2024,57.14,-57.14,461931.0,PCS,Issue to Patient,1.0,42.0,-42.0,45.0,1890.0
6310040016,DUODERM 20X20 CM DRES (GRANULFEX),Cosmetic,Rayan Hospital,RYN_IP,,,,1140594568,25-02-2024,57.14,-57.14,461931.0,PCS,Issue to Patient,1.0,42.0,-42.0,44.0,1848.0
6310040016,DUODERM 20X20 CM DRES (GRANULFEX),Cosmetic,Rayan Hospital,RYN_IP,,,,1140742293,26-02-2024,57.14,-57.14,461931.0,PCS,Issue to Patient,1.0,42.0,-42.0,43.0,1806.0
6310040016,DUODERM 20X20 CM DRES (GRANULFEX),Cosmetic,Rayan Hospital,RYN_IP,,,,1141171737,26-02-2024,57.14,-57.14,461931.0,PCS,Issue to Patient,1.0,42.0,-42.0,42.0,1764.0
6310040016,DUODERM 20X20 CM DRES (GRANULFEX),Cosmetic,Rayan Hospital,RYN_IP,,,,1141339326,27-02-2024,57.14,-57.14,461931.0,PCS,Issue to Patient,1.0,42.0,-42.0,41.0,1722.0
6310040016,DUODERM 20X20 CM DRES (GRANULFEX),Cosmetic,Rayan Hospital,RYN_IP,,,,1141749791,27-02-2024,57.14,-57.14,461931.0,PCS,Issue to Patient,1.0,42.0,-42.0,40.0,1680.0
6310040016,DUODERM 20X20 CM DRES (GRANULFEX),Cosmetic,Rayan Hospital,RYN_IP,,,,1141820441,28-02-2024,57.14,-57.14,461931.0,PCS,Issue to Patient,1.0,42.0,-42.0,39.0,1638.0
6310040016,DUODERM 20X20 CM DRES (GRANULFEX),Cosmetic,Rayan Hospital,RYN_IP,,,,1141820451,28-02-2024,57.14,-57.14,461931.0,PCS,Issue to Patient,1.0,42.0,-42.0,38.0,1596.0
6310040016,DUODERM 20X20 CM DRES (GRANULFEX),Cosmetic,Rayan Hospital,RYN_IP,,,,1141820456,28-02-2024,57.14,-57.14,461931.0,PCS,Issue to Patient,1.0,42.0,-42.0,37.0,1554.0
6310040016,DUODERM 20X20 CM DRES (GRANULFEX),Cosmetic,Rayan Hospital,RYN_IP,,,,1141821213,28-02-2024,57.14,-57.14,461931.0,PCS,Issue to Patient,1.0,42.0,-42.0,36.0,1512.0
6310040016,DUODERM 20X20 CM DRES (GRANULFEX),Cosmetic,Rayan Hospital,RYN_IP,,,,1141821218,28-02-2024,57.14,-57.14,461931.0,PCS,Issue to Patient,1.0,42.0,-42.0,35.0,1470.0
6310040016,DUODERM 20X20 CM DRES (GRANULFEX),Cosmetic,Rayan Hospital,RYN_IP,,,,1141821495,28-02-2024,57.14,-57.14,461931.0,PCS,Issue to Patient,1.0,42.0,-42.0,34.0,1428.0
6310040016,DUODERM 20X20 CM DRES (GRANULFEX),Cosmetic,Rayan Hospital,RYN_IP,,,,1141821500,28-02-2024,57.14,-57.14,461931.0,PCS,Issue to Patient,1.0,42.0,-42.0,33.0,1386.0
6310040016,DUODERM 20X20 CM DRES (GRANULFEX),Cosmetic,Rayan Hospital,RYN_IP,,,,1141821505,28-02-2024,57.14,-57.14,461931.0,PCS,Issue to Patient,1.0,42.0,-42.0,32.0,1344.0
6310040016,DUODERM 20X20 CM DRES (GRANULFEX),Cosmetic,Rayan Hospital,RYN_IP,,,,1141852658,28-02-2024,57.14,-57.14,461931.0,PCS,Issue to Patient,1.0,42.0,-42.0,31.0,1302.0
6310040016,DUODERM 20X20 CM DRES (GRANULFEX),Cosmetic,Rayan Hospital,RYN_IP,,,,1142348899,29-02-2024,57.14,-57.14,461931.0,PCS,Issue to Patient,1.0,42.0,-42.0,30.0,1260.0
6310040016,DUODERM 20X20 CM DRES (GRANULFEX),Cosmetic,Rayan Hospital,RYN_IP,,,,1143068442,01-03-2024,57.14,-57.14,461931.0,PCS,Issue to Patient,1.0,42.0,-42.0,29.0,1218.0
6310040016,DUODERM 20X20 CM DRES (GRANULFEX),Cosmetic,Rayan Hospital,RYN_IP,,,,1143467649,02-03-2024,57.14,-114.28,461931.0,PCS,Issue to Patient,2.0,42.0,-84.0,27.0,1134.0
6310040016,DUODERM 20X20 CM DRES (GRANULFEX),Cosmetic,Rayan Hospital,RYN_IP,,,,1143470208,02-03-2024,57.14,-114.28,461931.0,PCS,Issue to Patient,2.0,42.0,-84.0,25.0,1050.0
6310040016,DUODERM 20X20 CM DRES (GRANULFEX),Cosmetic,Rayan Hospital,RYN_IP,,,,1143470237,02-03-2024,57.14,-114.28,461931.0,PCS,Issue to Patient,2.0,42.0,-84.0,23.0,966.0
6310040016,DUODERM 20X20 CM DRES (GRANULFEX),Cosmetic,Rayan Hospital,RYN_IP,,,,1143470293,02-03-2024,57.14,-114.28,461931.0,PCS,Issue to Patient,2.0,42.0,-84.0,21.0,882.0
6310040016,DUODERM 20X20 CM DRES (GRANULFEX),Cosmetic,Rayan Hospital,RYN_IP,,,,1144947580,05-03-2024,57.14,-57.14,461931.0,PCS,Issue to Patient,1.0,42.0,-42.0,20.0,840.0
6310040016,DUODERM 20X20 CM DRES (GRANULFEX),Cosmetic,Rayan Hospital,RYN_IP,,,,1146193903,06-03-2024,57.14,-114.28,461931.0,PCS,Issue to Patient,2.0,42.0,-84.0,18.0,756.0
6310040016,DUODERM 20X20 CM DRES (GRANULFEX),Cosmetic,Rayan Hospital,RYN_IP,,,,1146213241,07-03-2024,57.14,-57.14,461931.0,PCS,Issue to Patient,1.0,42.0,-42.0,17.0,714.0
6310040016,DUODERM 20X20 CM DRES (GRANULFEX),Cosmetic,Rayan Hospital,RYN_IP,,,,1146214539,07-03-2024,57.14,-57.14,461931.0,PCS,Issue to Patient,1.0,42.0,-42.0,16.0,672.0
6310040016,DUODERM 20X20 CM DRES (GRANULFEX),Cosmetic,Rayan Hospital,RYN_IP,,,,1147597377,09-03-2024,57.14,-57.14,461931.0,PCS,Issue to Patient,1.0,42.0,-42.0,15.0,630.0
6310040016,DUODERM 20X20 CM DRES (GRANULFEX),Cosmetic,Rayan Hospital,RYN_IP,,,,1147599066,09-03-2024,57.14,-57.14,461931.0,PCS,Issue to Patient,1.0,42.0,-42.0,14.0,588.0
6310040016,DUODERM 20X20 CM DRES (GRANULFEX),Cosmetic,Rayan Hospital,RYN_IP,,,,1148245614,10-03-2024,57.14,-114.28,461931.0,PCS,Issue to Patient,2.0,42.0,-84.0,12.0,504.0
6310040016,DUODERM 20X20 CM DRES (GRANULFEX),Cosmetic,Rayan Hospital,RYN_IP,,,,1148257058,11-03-2024,57.14,-57.14,461931.0,PCS,Issue to Patient,1.0,42.0,-42.0,11.0,462.0
6310040016,DUODERM 20X20 CM DRES (GRANULFEX),Cosmetic,Rayan Hospital,RYN_IP,,,,1148259181,11-03-2024,57.14,-57.14,461931.0,PCS,Issue to Patient,1.0,42.0,-42.0,10.0,420.0
6310040016,DUODERM 20X20 CM DRES (GRANULFEX),Cosmetic,Rayan Hospital,RYN_IP,,,,1148259196,11-03-2024,57.14,-57.14,461931.0,PCS,Issue to Patient,1.0,42.0,-42.0,9.0,378.0
6310040016,DUODERM 20X20 CM DRES (GRANULFEX),Cosmetic,Rayan Hospital,RYN_IP,,,,1148260722,11-03-2024,57.14,-57.14,461931.0,PCS,Issue to Patient,1.0,42.0,-42.0,8.0,336.0
6310040016,DUODERM 20X20 CM DRES (GRANULFEX),Cosmetic,Rayan Hospital,RYN_IP,,,,1148697060,11-03-2024,57.14,-57.14,461931.0,PCS,Issue to Patient,1.0,42.0,-42.0,7.0,294.0
6310040016,DUODERM 20X20 CM DRES (GRANULFEX),Cosmetic,Rayan Hospital,RYN_IP,,,,1148707206,12-03-2024,57.14,-57.14,461931.0,PCS,Issue to Patient,1.0,42.0,-42.0,6.0,252.0
6310040016,DUODERM 20X20 CM DRES (GRANULFEX),Cosmetic,Rayan Hospital,RYN_IP,,,,1148747573,12-03-2024,57.14,-57.14,461931.0,PCS,Issue to Patient,1.0,42.0,-42.0,5.0,210.0
6310040016,DUODERM 20X20 CM DRES (GRANULFEX),Cosmetic,Rayan Hospital,RYN_IP,,,,1149281297,13-03-2024,57.14,-57.14,461931.0,PCS,Issue to Patient,1.0,42.0,-42.0,10.0,420.0
6310040016,DUODERM 20X20 CM DRES (GRANULFEX),Cosmetic,Rayan Hospital,RYN_IP,,,,1149289306,13-03-2024,57.14,-114.28,461931.0,PCS,Issue to Patient,2.0,42.0,-84.0,8.0,336.0
6310040016,DUODERM 20X20 CM DRES (GRANULFEX),Cosmetic,Rayan Hospital,RYN_IP,,,,1149318522,13-03-2024,57.14,-114.28,461931.0,PCS,Issue to Patient,2.0,42.0,-84.0,6.0,252.0
6310040016,DUODERM 20X20 CM DRES (GRANULFEX),Cosmetic,Rayan Hospital,RYN_IP,,,,1149319487,13-03-2024,57.14,-57.14,461931.0,PCS,Issue to Patient,1.0,42.0,-42.0,5.0,210.0
6310040016,DUODERM 20X20 CM DRES (GRANULFEX),Cosmetic,Rayan Hospital,RYN_IP,,,,1149702997,13-03-2024,57.14,-57.14,461931.0,PCS,Issue to Patient,1.0,42.0,-42.0,4.0,168.0
6310040016,DUODERM 20X20 CM DRES (GRANULFEX),Cosmetic,Rayan Hospital,RYN_IP,,,,1149782439,14-03-2024,57.14,-57.14,461931.0,PCS,Issue to Patient,1.0,42.0,-42.0,3.0,126.0
6310040016,DUODERM 20X20 CM DRES (GRANULFEX),Cosmetic,Rayan Hospital,RYN_IP,,,,1149782449,14-03-2024,57.14,-114.28,461931.0,PCS,Issue to Patient,2.0,42.0,-84.0,1.0,42.0
6310040016,DUODERM 20X20 CM DRES (GRANULFEX),Cosmetic,Rayan Hospital,RYN_IP,,,,1150164564,14-03-2024,57.14,-57.14,461931.0,PCS,Issue to Patient,1.0,42.0,-42.0,0.0,0.0
6310040016,DUODERM 20X20 CM DRES (GRANULFEX),Cosmetic,Rayan Hospital,RYN_IP,,,,1161264098,07-04-2024,57.14,-57.14,461932.0,PCS,Issue to Patient,1.0,42.0,-42.0,99.0,4158.0
6310040016,DUODERM 20X20 CM DRES (GRANULFEX),Cosmetic,Rayan Hospital,RYN_IP,,,,1161972301,10-04-2024,57.14,-57.14,461932.0,PCS,Issue to Patient,1.0,42.0,-42.0,98.0,4116.0
6310040016,DUODERM 20X20 CM DRES (GRANULFEX),Cosmetic,Rayan Hospital,RYN_IP,,,,1162155570,11-04-2024,57.14,-57.14,461932.0,PCS,Issue to Patient,1.0,42.0,-42.0,97.0,4074.0
6310040016,DUODERM 20X20 CM DRES (GRANULFEX),Cosmetic,Rayan Hospital,RYN_IP,,,,1162560160,13-04-2024,57.14,-114.28,461932.0,PCS,Issue to Patient,2.0,42.0,-84.0,95.0,3990.0
6310040016,DUODERM 20X20 CM DRES (GRANULFEX),Cosmetic,Rayan Hospital,RYN_IP,,,,1162593072,13-04-2024,57.14,-57.14,461932.0,PCS,Issue to Patient,1.0,42.0,-42.0,94.0,3948.0
6310040016,DUODERM 20X20 CM DRES (GRANULFEX),Cosmetic,Rayan Hospital,RYN_IP,,,,1163671066,16-04-2024,57.14,-57.14,461932.0,PCS,Issue to Patient,1.0,42.0,-42.0,93.0,3906.0
6310040016,DUODERM 20X20 CM DRES (GRANULFEX),Cosmetic,Rayan Hospital,RYN_IP,,,,1164801066,18-04-2024,57.14,-57.14,461932.0,PCS,Issue to Patient,1.0,42.0,-42.0,92.0,3864.0
6310040016,DUODERM 20X20 CM DRES (GRANULFEX),Cosmetic,Rayan Hospital,RYN_IP,,,,1165341176,19-04-2024,57.14,-114.28,461932.0,PCS,Issue to Patient,2.0,42.08786,-84.17572,140.0,5892.30075
6310040016,DUODERM 20X20 CM DRES (GRANULFEX),Cosmetic,Rayan Hospital,RYN_IP,,,,1166339290,21-04-2024,57.14,-57.14,461932.0,PCS,Issue to Patient,1.0,42.08786,-42.08786,139.0,5850.21289
6310040016,DUODERM 20X20 CM DRES (GRANULFEX),Cosmetic,Rayan Hospital,RYN_IP,,,,1166759875,22-04-2024,57.14,-57.14,461932.0,PCS,Issue to Patient,1.0,42.08786,-42.08786,138.0,5808.12502
6310040016,DUODERM 20X20 CM DRES (GRANULFEX),Cosmetic,Rayan Hospital,STAGE,Rayan Hospital Clinics,RAY_RT,17546207,1167559331,23-04-2024,57.14,-571.4,461932.0,PCS,Int Order Direct Ship,10.0,42.08786,-420.87862,128.0,5387.2464
6310040016,DUODERM 20X20 CM DRES (GRANULFEX),Cosmetic,Rayan Hospital,RYN_IP,,,,1167941735,24-04-2024,57.14,-57.14,461932.0,PCS,Issue to Patient,1.0,42.08786,-42.08786,127.0,5345.15854
6310040016,DUODERM 20X20 CM DRES (GRANULFEX),Cosmetic,Rayan Hospital,RYN_IP,,,,1167996158,24-04-2024,57.14,-57.14,461932.0,PCS,Issue to Patient,1.0,42.08786,-42.08786,126.0,5303.07067
6310040016,DUODERM 20X20 CM DRES (GRANULFEX),Cosmetic,Rayan Hospital,RYN_IP,,,,1167996163,24-04-2024,57.14,-57.14,461932.0,PCS,Issue to Patient,1.0,42.08786,-42.08786,125.0,5260.98281
6310040016,DUODERM 20X20 CM DRES (GRANULFEX),Cosmetic,Rayan Hospital,RYN_IP,,,,1167996198,24-04-2024,57.14,-57.14,461932.0,PCS,Issue to Patient,1.0,42.08786,-42.08786,124.0,5218.89495
6310040016,DUODERM 20X20 CM DRES (GRANULFEX),Cosmetic,Rayan Hospital,RYN_IP,,,,1168559328,25-04-2024,57.14,-57.14,461932.0,PCS,Issue to Patient,1.0,42.08786,-42.08786,123.0,5176.80709
6310040016,DUODERM 20X20 CM DRES (GRANULFEX),Cosmetic,Rayan Hospital,RYN_IP,,,,1169057280,25-04-2024,57.14,-57.14,461932.0,PCS,Issue to Patient,1.0,42.08786,-42.08786,122.0,5134.71922
6310040016,DUODERM 20X20 CM DRES (GRANULFEX),Cosmetic,Rayan Hospital,RYN_IP,,,,1169815649,27-04-2024,57.14,-114.28,461932.0,PCS,Issue to Patient,2.0,42.08786,-84.17572,120.0,5050.5435
6310040016,DUODERM 20X20 CM DRES (GRANULFEX),Cosmetic,Rayan Hospital,RYN_IP,,,,1169832260,27-04-2024,57.14,-114.28,461932.0,PCS,Issue to Patient,2.0,42.08786,-84.17572,118.0,4966.36777
6310040016,DUODERM 20X20 CM DRES (GRANULFEX),Cosmetic,Rayan Hospital,RYN_IP,,,,1169832270,27-04-2024,57.14,-114.28,461932.0,PCS,Issue to Patient,2.0,42.08786,-84.17572,116.0,4882.19205
6310040016,DUODERM 20X20 CM DRES (GRANULFEX),Cosmetic,Rayan Hospital,RYN_IP,,,,1169998723,28-04-2024,57.14,-57.14,461932.0,PCS,Issue to Patient,1.0,42.08786,-42.08786,115.0,4840.10419
6310040016,DUODERM 20X20 CM DRES (GRANULFEX),Cosmetic,Rayan Hospital,RYN_IP,,,,1171216624,30-04-2024,57.14,-57.14,461932.0,PCS,Issue to Patient,1.0,42.08786,-42.08786,114.0,4798.01632
6310040016,DUODERM 20X20 CM DRES (GRANULFEX),Cosmetic,Rayan Hospital,RYN_IP,,,,1171779801,30-04-2024,57.14,-57.14,461932.0,PCS,Issue to Patient,1.0,42.08786,-42.08786,113.0,4755.92846
6310040016,DUODERM 20X20 CM DRES (GRANULFEX),Cosmetic,Rayan Hospital,RYN_IP,,,,1171811335,01-05-2024,57.14,-114.28,461932.0,PCS,Issue to Patient,2.0,42.08786,-84.17572,111.0,4671.75274
6310040016,DUODERM 20X20 CM DRES (GRANULFEX),Cosmetic,Rayan Hospital,RYN_IP,,,,1172446175,02-05-2024,57.14,-57.14,461932.0,PCS,Issue to Patient,1.0,42.08786,-42.08786,110.0,4629.66487
6310040016,DUODERM 20X20 CM DRES (GRANULFEX),Cosmetic,Rayan Hospital,RYN_IP,,,,1172500685,02-05-2024,57.14,-57.14,461932.0,PCS,Issue to Patient,1.0,42.08786,-42.08786,109.0,4587.57701
6310040016,DUODERM 20X20 CM DRES (GRANULFEX),Cosmetic,Rayan Hospital,RYN_IP,,,,1175077642,07-05-2024,57.14,-57.14,461932.0,PCS,Issue to Patient,1.0,42.08786,-42.08786,108.0,4545.48915
6310040016,DUODERM 20X20 CM DRES (GRANULFEX),Cosmetic,Rayan Hospital,RYN_IP,,,,1175079654,07-05-2024,57.14,-57.14,461932.0,PCS,Issue to Patient,1.0,42.08786,-42.08786,107.0,4503.40129
6310040016,DUODERM 20X20 CM DRES (GRANULFEX),Cosmetic,Rayan Hospital,RYN_IP,,,,1175080099,07-05-2024,57.14,-57.14,461932.0,PCS,Issue to Patient,1.0,42.08786,-42.08786,106.0,4461.31342
6310040016,DUODERM 20X20 CM DRES (GRANULFEX),Cosmetic,Rayan Hospital,RYN_IP,,,,1175080109,07-05-2024,57.14,-57.14,461932.0,PCS,Issue to Patient,1.0,42.08786,-42.08786,105.0,4419.22556
6310040016,DUODERM 20X20 CM DRES (GRANULFEX),Cosmetic,Rayan Hospital,RYN_IP,,,,1175080114,07-05-2024,57.14,-57.14,461932.0,PCS,Issue to Patient,1.0,42.08786,-42.08786,104.0,4377.1377
6310040016,DUODERM 20X20 CM DRES (GRANULFEX),Cosmetic,Rayan Hospital,RYN_IP,,,,1175080119,07-05-2024,57.14,-57.14,461932.0,PCS,Issue to Patient,1.0,42.08786,-42.08786,103.0,4335.04984
6310040016,DUODERM 20X20 CM DRES (GRANULFEX),Cosmetic,Rayan Hospital,RYN_IP,,,,1175080420,07-05-2024,57.14,-57.14,461932.0,PCS,Issue to Patient,1.0,42.08786,-42.08786,102.0,4292.96197
6310040016,DUODERM 20X20 CM DRES (GRANULFEX),Cosmetic,Rayan Hospital,RYN_IP,,,,1175080956,07-05-2024,57.14,-57.14,461932.0,PCS,Issue to Patient,1.0,42.08786,-42.08786,101.0,4250.87411
6310040016,DUODERM 20X20 CM DRES (GRANULFEX),Cosmetic,Rayan Hospital,RYN_IP,,,,1175525722,07-05-2024,57.14,-57.14,461932.0,PCS,Issue to Patient,1.0,42.08786,-42.08786,100.0,4208.78625
6310040016,DUODERM 20X20 CM DRES (GRANULFEX),Cosmetic,Rayan Hospital,RYN_IP,,,,1175529066,07-05-2024,57.14,-57.14,461932.0,PCS,Issue to Patient,1.0,42.08786,-42.08786,99.0,4166.69839
6310040016,DUODERM 20X20 CM DRES (GRANULFEX),Cosmetic,Rayan Hospital,RYN_IP,,,,1175533979,07-05-2024,57.14,-57.14,461932.0,PCS,Issue to Patient,1.0,42.08786,-42.08786,98.0,4124.61052
6310040016,DUODERM 20X20 CM DRES (GRANULFEX),Cosmetic,Rayan Hospital,RYN_IP,,,,1175644828,08-05-2024,57.14,-57.14,461932.0,PCS,Issue to Patient,1.0,42.08786,-42.08786,97.0,4082.52266
6310040016,DUODERM 20X20 CM DRES (GRANULFEX),Cosmetic,Rayan Hospital,RYN_IP,,,,1177680667,12-05-2024,57.14,-57.14,461932.0,PCS,Issue to Patient,1.0,42.08786,-42.08786,96.0,4040.4348
6310040016,DUODERM 20X20 CM DRES (GRANULFEX),Cosmetic,Rayan Hospital,RYN_IP,,,,1178369853,13-05-2024,57.14,-57.14,461932.0,PCS,Issue to Patient,1.0,42.08786,-42.08786,95.0,3998.34694
6310040016,DUODERM 20X20 CM DRES (GRANULFEX),Cosmetic,Rayan Hospital,RYN_IP,,,,1178661369,13-05-2024,57.14,-114.28,461932.0,PCS,Issue to Patient,2.0,42.08786,-84.17572,93.0,3914.17121
6310040016,DUODERM 20X20 CM DRES (GRANULFEX),Cosmetic,Rayan Hospital,RYN_IP,,,,1179089795,14-05-2024,57.14,-57.14,461932.0,PCS,Issue to Patient,1.0,42.08786,-42.08786,92.0,3872.08335
6310040016,DUODERM 20X20 CM DRES (GRANULFEX),Cosmetic,Rayan Hospital,RYN_IP,,,,1179091730,14-05-2024,57.14,-114.28,461932.0,PCS,Issue to Patient,2.0,42.08786,-84.17572,90.0,3787.90762
6310040016,DUODERM 20X20 CM DRES (GRANULFEX),Cosmetic,Rayan Hospital,RYN_IP,,,,1179667053,15-05-2024,57.14,-285.7,461932.0,PCS,Issue to Patient,5.0,42.08786,-210.43931,86.0,3619.55617
6310040016,DUODERM 20X20 CM DRES (GRANULFEX),Cosmetic,Rayan Hospital,RYN_IP,,,,1179668432,15-05-2024,57.14,-228.56,461932.0,PCS,Issue to Patient,4.0,42.08786,-168.35145,82.0,3451.20472
6310040016,DUODERM 20X20 CM DRES (GRANULFEX),Cosmetic,Rayan Hospital,RYN_IP,,,,1180281065,16-05-2024,57.14,-57.14,461932.0,PCS,Issue to Patient,1.0,42.08786,-42.08786,81.0,3409.11686
6310040016,DUODERM 20X20 CM DRES (GRANULFEX),Cosmetic,Rayan Hospital,RYN_IP,,,,1180281815,16-05-2024,57.14,-57.14,461932.0,PCS,Issue to Patient,1.0,42.08786,-42.08786,80.0,3367.029
6310040016,DUODERM 20X20 CM DRES (GRANULFEX),Cosmetic,Rayan Hospital,RYN_IP,,,,1180294883,16-05-2024,57.14,-228.56,461932.0,PCS,Issue to Patient,4.0,42.08786,-168.35145,76.0,3198.67755
6310040016,DUODERM 20X20 CM DRES (GRANULFEX),Cosmetic,Rayan Hospital,RYN_IP,,,,1180445112,16-05-2024,57.14,-57.14,461932.0,PCS,Issue to Patient,1.0,42.08786,-42.08786,75.0,3156.58969
6310040016,DUODERM 20X20 CM DRES (GRANULFEX),Cosmetic,Rayan Hospital,RYN_IP,,,,1181100372,17-05-2024,57.14,-57.14,461932.0,PCS,Issue to Patient,1.0,42.08786,-42.08786,74.0,3114.50182
6310040016,DUODERM 20X20 CM DRES (GRANULFEX),Cosmetic,Rayan Hospital,RYN_IP,,,,1181520879,18-05-2024,57.14,-114.28,461932.0,PCS,Issue to Patient,2.0,42.08786,-84.17572,72.0,3030.3261
6310040016,DUODERM 20X20 CM DRES (GRANULFEX),Cosmetic,Rayan Hospital,RYN_IP,,,,1181724026,18-05-2024,57.14,-57.14,461932.0,PCS,Issue to Patient,1.0,42.08786,-42.08786,71.0,2988.23824
6310040016,DUODERM 20X20 CM DRES (GRANULFEX),Cosmetic,Rayan Hospital,RYN_IP,,,,1182405873,19-05-2024,57.14,-114.28,461932.0,PCS,Issue to Patient,2.0,42.08786,-84.17572,69.0,2904.06251
6310040016,DUODERM 20X20 CM DRES (GRANULFEX),Cosmetic,Rayan Hospital,RYN_IP,,,,1184386909,23-05-2024,57.14,-114.28,461932.0,PCS,Issue to Patient,2.0,42.08786,-84.17572,67.0,2819.88679
6310040016,DUODERM 20X20 CM DRES (GRANULFEX),Cosmetic,Rayan Hospital,STAGE,Rayan Hospital Clinics,RAY_RT,17625919,1184604669,23-05-2024,57.14,-571.4,461932.0,PCS,Int Order Direct Ship,10.0,42.08786,-420.87862,57.0,2399.00816
6310040016,DUODERM 20X20 CM DRES (GRANULFEX),Cosmetic,Rayan Hospital,RYN_IP,,,,1185160139,25-05-2024,57.14,-114.28,461932.0,PCS,Issue to Patient,2.0,42.08786,-84.17572,55.0,2314.83244
6310040016,DUODERM 20X20 CM DRES (GRANULFEX),Cosmetic,Rayan Hospital,RYN_IP,,,,1186371593,27-05-2024,57.14,-114.28,461932.0,PCS,Issue to Patient,2.0,42.08786,-84.17572,53.0,2230.65671
6310040016,DUODERM 20X20 CM DRES (GRANULFEX),Cosmetic,Rayan Hospital,RYN_IP,,,,1186696226,27-05-2024,57.14,-57.14,461932.0,PCS,Issue to Patient,1.0,42.08786,-42.08786,52.0,2188.56885
6310040016,DUODERM 20X20 CM DRES (GRANULFEX),Cosmetic,Rayan Hospital,RYN_IP,,,,1187064058,28-05-2024,57.14,-57.14,461932.0,PCS,Issue to Patient,1.0,42.08786,-42.08786,51.0,2146.48099
6310040016,DUODERM 20X20 CM DRES (GRANULFEX),Cosmetic,Rayan Hospital,RYN_IP,,,,1187082555,28-05-2024,57.14,-57.14,461932.0,PCS,Issue to Patient,1.0,42.08786,-42.08786,50.0,2104.39312
6310040016,DUODERM 20X20 CM DRES (GRANULFEX),Cosmetic,Rayan Hospital,RYN_IP,,,,1187625062,28-05-2024,57.14,-57.14,461932.0,PCS,Issue to Patient,1.0,42.08786,-42.08786,49.0,2062.30526
6310040016,DUODERM 20X20 CM DRES (GRANULFEX),Cosmetic,Rayan Hospital,RYN_IP,,,,1189039393,31-05-2024,57.14,-57.14,461932.0,PCS,Issue to Patient,1.0,42.08786,-42.08786,48.0,2020.2174
6310040016,DUODERM 20X20 CM DRES (GRANULFEX),Cosmetic,Rayan Hospital,RYN_IP,,,,1189196932,31-05-2024,57.14,-57.14,461932.0,PCS,Issue to Patient,1.0,42.08786,-42.08786,47.0,1978.12954
6310040016,DUODERM 20X20 CM DRES (GRANULFEX),Cosmetic,Rayan Hospital,RYN_IP,,,,1190526441,03-06-2024,57.14,-57.14,461932.0,PCS,Issue to Patient,1.0,42.10264,-42.10264,48.0,2020.92694
6310040016,DUODERM 20X20 CM DRES (GRANULFEX),Cosmetic,Rayan Hospital,RYN_IP,,,,1191071501,03-06-2024,57.14,-57.14,461932.0,PCS,Issue to Patient,1.0,42.10264,-42.10264,47.0,1978.82429
6310040016,DUODERM 20X20 CM DRES (GRANULFEX),Cosmetic,Rayan Hospital,RYN_IP,,,,1191839714,05-06-2024,57.14,-57.14,461932.0,PCS,Issue to Patient,1.0,42.10264,-42.10264,46.0,1936.72165
6310040016,DUODERM 20X20 CM DRES (GRANULFEX),Cosmetic,Rayan Hospital,STAGE,Rayan Hospital Clinics,RAY_RT,17647482,1192673878,06-06-2024,57.14,-114.28,461931.0,PCS,Int Order Direct Ship,2.0,42.10264,-84.20529,44.0,1852.51636
6310040016,DUODERM 20X20 CM DRES (GRANULFEX),Cosmetic,Rayan Hospital,STAGE,Rayan Hospital Clinics,RAY_RT,17647482,1192673888,06-06-2024,57.14,-457.12,461932.0,PCS,Int Order Direct Ship,8.0,42.10264,-336.82116,36.0,1515.6952
6310040016,DUODERM 20X20 CM DRES (GRANULFEX),Cosmetic,Rayan Hospital,RYN_IP,,,,1193242854,07-06-2024,57.14,-57.14,461932.0,PCS,Issue to Patient,1.0,42.10264,-42.10264,35.0,1473.59256
6310040016,DUODERM 20X20 CM DRES (GRANULFEX),Cosmetic,Rayan Hospital,RYN_IP,,,,1193335843,07-06-2024,57.14,-114.28,461932.0,PCS,Issue to Patient,2.0,42.10264,-84.20529,33.0,1389.38727
6310040016,DUODERM 20X20 CM DRES (GRANULFEX),Cosmetic,Rayan Hospital,RYN_IP,,,,1193702699,08-06-2024,57.14,-57.14,461932.0,PCS,Issue to Patient,1.0,42.10264,-42.10264,32.0,1347.28462
6310040016,DUODERM 20X20 CM DRES (GRANULFEX),Cosmetic,Rayan Hospital,RYN_IP,,,,1193710129,08-06-2024,57.14,-114.28,461932.0,PCS,Issue to Patient,2.0,42.10264,-84.20529,30.0,1263.07933
6310040016,DUODERM 20X20 CM DRES (GRANULFEX),Cosmetic,Rayan Hospital,RYN_IP,,,,1193711011,08-06-2024,57.14,-171.42,461932.0,PCS,Issue to Patient,3.0,42.10264,-126.30793,27.0,1136.7714
6310040016,DUODERM 20X20 CM DRES (GRANULFEX),Cosmetic,Rayan Hospital,RYN_IP,,,,1195329717,11-06-2024,57.14,-57.14,461932.0,PCS,Issue to Patient,1.0,42.10264,-42.10264,26.0,1094.66876
6310040016,DUODERM 20X20 CM DRES (GRANULFEX),Cosmetic,Rayan Hospital,RYN_IP,,,,1195329732,11-06-2024,57.14,-114.28,461932.0,PCS,Issue to Patient,2.0,42.10264,-84.20529,24.0,1010.46347
6310040016,DUODERM 20X20 CM DRES (GRANULFEX),Cosmetic,Rayan Hospital,RYN_IP,,,,1195329747,11-06-2024,57.14,-114.28,461932.0,PCS,Issue to Patient,2.0,42.10264,-84.20529,22.0,926.25818
6310040016,DUODERM 20X20 CM DRES (GRANULFEX),Cosmetic,Rayan Hospital,RYN_IP,,,,1195910279,11-06-2024,57.14,-114.28,461932.0,PCS,Issue to Patient,2.0,42.10264,-84.20529,20.0,842.05289
6310040016,DUODERM 20X20 CM DRES (GRANULFEX),Cosmetic,Rayan Hospital,RYN_IP,,,,1195961891,11-06-2024,57.14,-57.14,461932.0,PCS,Issue to Patient,1.0,42.10264,-42.10264,19.0,799.95025
6310040016,DUODERM 20X20 CM DRES (GRANULFEX),Cosmetic,Rayan Hospital,RYN_IP,,,,1195966575,11-06-2024,57.14,-114.28,461932.0,PCS,Issue to Patient,2.0,42.10264,-84.20529,17.0,715.74496
6310040016,DUODERM 20X20 CM DRES (GRANULFEX),Cosmetic,Rayan Hospital,RYN_IP,,,,1196633631,13-06-2024,57.14,-114.28,461932.0,PCS,Issue to Patient,2.0,42.10264,-84.20529,15.0,631.53967
6310040016,DUODERM 20X20 CM DRES (GRANULFEX),Cosmetic,Rayan Hospital,STAGE,Rayan Hospital Clinics,RAY_RT,17657960,1196842540,13-06-2024,57.14,-571.4,461932.0,PCS,Int Order Direct Ship,10.0,42.10264,-421.02644,5.0,210.51322
6310040016,DUODERM 20X20 CM DRES (GRANULFEX),Cosmetic,Rayan Hospital,RYN_IP,,,,1197135268,13-06-2024,57.14,-57.14,461932.0,PCS,Issue to Patient,1.0,42.10264,-42.10264,4.0,168.41058
6310040016,DUODERM 20X20 CM DRES (GRANULFEX),Cosmetic,Rayan Hospital,RYN_IP,,,,1197265328,14-06-2024,57.14,-114.28,461932.0,PCS,Issue to Patient,2.0,42.10264,-84.20529,2.0,84.20529
6310040016,DUODERM 20X20 CM DRES (GRANULFEX),Cosmetic,Rayan Hospital,RYN_IP,,,,1197359472,14-06-2024,57.14,-57.14,461932.0,PCS,Issue to Patient,1.0,42.10264,-42.10264,1.0,42.10264
6310040016,DUODERM 20X20 CM DRES (GRANULFEX),Cosmetic,Rayan Hospital,RYN_IP,,,,1197610106,15-06-2024,57.14,-57.14,461932.0,PCS,Issue to Patient,1.0,42.10264,-42.10264,0.0,0.0
