Item Code,Description,Item Category,Oraganization,Sub Inventory,To Location,To Subinventory,Document Number,Transaction ID,Transaction DATE,SellingÂ  Price,Value of Selling Price,Lot Number,UOM,Transaction Type,Transaction Quantity,Transaction Cost,Transaction Value,Balance Quantity,Balance Value
6560020099,VOLTAREN 50 MG SUP 10'S,Medicine,Rayan Hospital,RYN_IP,,,,1110840907,01-01-2024,19.9,-3.98,644985.0,BOX,Issue to Patient,0.2,12.54252,-2.5085,6.7,84.03486
6560020099,VOLTAREN 50 MG SUP 10'S,Medicine,Rayan Hospital,STAGE,Rayan Hospital Clinics,RAY_RCVRY,17447316,1111018867,01-01-2024,19.9,-9.95,644985.0,BOX,Int Order Direct Ship,0.5,12.54252,-6.27126,6.2,77.7636
6560020099,VOLTAREN 50 MG SUP 10'S,Medicine,Rayan Hospital,RYN_IP,,,,1111416013,02-01-2024,19.9,-1.99,644988.0,BOX,Issue to Patient,0.1,12.54252,-1.25425,6.1,76.50935
6560020099,VOLTAREN 50 MG SUP 10'S,Medicine,Rayan Hospital,RYN_IP,,,,1111437134,02-01-2024,19.9,-3.98,644985.0,BOX,Issue to Patient,0.2,12.54252,-2.5085,5.9,74.00085
6560020099,VOLTAREN 50 MG SUP 10'S,Medicine,Rayan Hospital,RYN_IP,,,,1111998549,03-01-2024,19.9,-1.99,644988.0,BOX,Issue to Patient,0.1,12.54252,-1.25425,5.8,72.74659
6560020099,VOLTAREN 50 MG SUP 10'S,Medicine,Rayan Hospital,RYN_IP,,,,1112000010,03-01-2024,19.9,-1.99,644988.0,BOX,Issue to Patient,0.1,12.54252,-1.25425,5.7,71.49234
6560020099,VOLTAREN 50 MG SUP 10'S,Medicine,Rayan Hospital,RYN_IP,,,,1112017491,03-01-2024,19.9,-3.98,644988.0,BOX,Issue to Patient,0.2,12.54252,-2.5085,5.5,68.98384
6560020099,VOLTAREN 50 MG SUP 10'S,Medicine,Rayan Hospital,RYN_IP,,,,1112039085,03-01-2024,19.9,-3.98,644988.0,BOX,Issue to Patient,0.2,12.54252,-2.5085,5.3,66.47534
6560020099,VOLTAREN 50 MG SUP 10'S,Medicine,Rayan Hospital,RYN_IP,,,,1112570220,04-01-2024,19.9,-1.99,644988.0,BOX,Issue to Patient,0.1,12.54252,-1.25425,5.4,67.72959
6560020099,VOLTAREN 50 MG SUP 10'S,Medicine,Rayan Hospital,RYN_IP,,,,1112579754,04-01-2024,19.9,-1.99,644988.0,BOX,Issue to Patient,0.1,12.54252,-1.25425,5.3,66.47534
6560020099,VOLTAREN 50 MG SUP 10'S,Medicine,Rayan Hospital,RYN_IP,,,,1112592051,04-01-2024,19.9,-3.98,644988.0,BOX,Issue to Patient,0.2,12.54252,-2.5085,5.1,63.96683
6560020099,VOLTAREN 50 MG SUP 10'S,Medicine,Rayan Hospital,RYN_IP,,,,1112592066,04-01-2024,19.9,-3.98,644988.0,BOX,Issue to Patient,0.2,12.54252,-2.5085,4.9,61.45833
6560020099,VOLTAREN 50 MG SUP 10'S,Medicine,Rayan Hospital,RYN_IP,,,,1112597296,04-01-2024,19.9,-5.97,644988.0,BOX,Issue to Patient,0.2999,12.54252,-3.7615,4.6001,57.69683
6560020099,VOLTAREN 50 MG SUP 10'S,Medicine,Rayan Hospital,RYN_IP,,,,1112601487,04-01-2024,19.9,-1.99,644988.0,BOX,Issue to Patient,0.1,12.54252,-1.25425,4.5001,56.44258
6560020099,VOLTAREN 50 MG SUP 10'S,Medicine,Rayan Hospital,RYN_IP,,,,1112643504,04-01-2024,19.9,-5.97,644988.0,BOX,Issue to Patient,0.2999,12.54252,-3.7615,4.2002,52.68108
6560020099,VOLTAREN 50 MG SUP 10'S,Medicine,Rayan Hospital,RYN_IP,,,,1112660350,04-01-2024,19.9,-5.97,644988.0,BOX,Issue to Patient,0.2999,12.54252,-3.7615,3.9003,48.91958
6560020099,VOLTAREN 50 MG SUP 10'S,Medicine,Rayan Hospital,RYN_IP,,,,1113887992,07-01-2024,19.9,-1.99,644988.0,BOX,Issue to Patient,0.1,12.54252,-1.25425,4.4003,55.19083
6560020099,VOLTAREN 50 MG SUP 10'S,Medicine,Rayan Hospital,RYN_IP,,,,1113919712,07-01-2024,19.9,-1.99,644988.0,BOX,Issue to Patient,0.1,12.54252,-1.25425,4.3003,53.93658
6560020099,VOLTAREN 50 MG SUP 10'S,Medicine,Rayan Hospital,RYN_IP,,,,1113926815,07-01-2024,19.9,-3.98,644988.0,BOX,Issue to Patient,0.2,12.54252,-2.5085,4.1003,51.42808
6560020099,VOLTAREN 50 MG SUP 10'S,Medicine,Rayan Hospital,RYN_IP,,,,1113926879,07-01-2024,19.9,-3.98,644988.0,BOX,Issue to Patient,0.2,12.54252,-2.5085,3.9003,48.91958
6560020099,VOLTAREN 50 MG SUP 10'S,Medicine,Rayan Hospital,RYN_IP,,,,1113946535,07-01-2024,19.9,-5.97,644988.0,BOX,Issue to Patient,0.2999,12.54252,-3.7615,3.6004,45.15808
6560020099,VOLTAREN 50 MG SUP 10'S,Medicine,Rayan Hospital,RYN_IP,,,,1113979887,07-01-2024,19.9,-5.97,644988.0,BOX,Issue to Patient,0.2999,12.54252,-3.7615,3.3005,41.39657
6560020099,VOLTAREN 50 MG SUP 10'S,Medicine,Rayan Hospital,RYN_IP,,,,1117107781,13-01-2024,19.9,-3.98,644988.0,BOX,Issue to Patient,0.2,12.54252,-2.5085,5.1005,63.9731
6560020099,VOLTAREN 50 MG SUP 10'S,Medicine,Rayan Hospital,RYN_IP,,,,1117539327,14-01-2024,19.9,-1.99,644988.0,BOX,Issue to Patient,0.1,12.54252,-1.25425,5.0005,62.71885
6560020099,VOLTAREN 50 MG SUP 10'S,Medicine,Rayan Hospital,RYN_IP,,,,1117558528,14-01-2024,19.9,-3.98,644988.0,BOX,Issue to Patient,0.2,12.54252,-2.5085,4.8005,60.21035
6560020099,VOLTAREN 50 MG SUP 10'S,Medicine,Rayan Hospital,RYN_IP,,,,1117597541,14-01-2024,19.9,-1.99,644988.0,BOX,Issue to Patient,0.1,12.54252,-1.25425,4.7005,58.9561
6560020099,VOLTAREN 50 MG SUP 10'S,Medicine,Rayan Hospital,RYN_IP,,,,1117639619,14-01-2024,19.9,-3.98,644988.0,BOX,Issue to Patient,0.2,12.54252,-2.5085,4.6005,57.70185
6560020099,VOLTAREN 50 MG SUP 10'S,Medicine,Rayan Hospital,RYN_IP,,,,1117642521,14-01-2024,19.9,-3.98,644988.0,BOX,Issue to Patient,0.2,12.54252,-2.5085,4.4005,55.19334
6560020099,VOLTAREN 50 MG SUP 10'S,Medicine,Rayan Hospital,RYN_IP,,,,1117642648,14-01-2024,19.9,-3.98,644988.0,BOX,Issue to Patient,0.2,12.54252,-2.5085,4.2005,52.68484
6560020099,VOLTAREN 50 MG SUP 10'S,Medicine,Rayan Hospital,RYN_IP,,,,1117646656,14-01-2024,19.9,-3.98,644988.0,BOX,Issue to Patient,0.2,12.54252,-2.5085,4.0005,50.17634
6560020099,VOLTAREN 50 MG SUP 10'S,Medicine,Rayan Hospital,RYN_IP,,,,1117954868,14-01-2024,19.9,-1.99,644990.0,BOX,Issue to Patient,0.1,12.54252,-1.25425,3.9005,48.92208
6560020099,VOLTAREN 50 MG SUP 10'S,Medicine,Rayan Hospital,RYN_IP,,,,1118148234,15-01-2024,19.9,-1.99,644988.0,BOX,Issue to Patient,0.1,12.54252,-1.25425,4.1005,51.43059
6560020099,VOLTAREN 50 MG SUP 10'S,Medicine,Rayan Hospital,RYN_IP,,,,1118166160,15-01-2024,19.9,-1.99,644988.0,BOX,Issue to Patient,0.1,12.54252,-1.25425,4.0005,50.17634
6560020099,VOLTAREN 50 MG SUP 10'S,Medicine,Rayan Hospital,RYN_IP,,,,1118217455,15-01-2024,19.9,-3.98,644988.0,BOX,Issue to Patient,0.2,12.54252,-2.5085,3.9005,48.92208
6560020099,VOLTAREN 50 MG SUP 10'S,Medicine,Rayan Hospital,RYN_IP,,,,1118228336,15-01-2024,19.9,-5.97,644990.0,BOX,Issue to Patient,0.2999,12.54252,-3.7615,3.6006,45.16058
6560020099,VOLTAREN 50 MG SUP 10'S,Medicine,Rayan Hospital,RYN_IP,,,,1118263408,15-01-2024,19.9,-5.97,644988.0,BOX,Issue to Patient,0.2999,12.54252,-3.7615,3.3007,41.39908
6560020099,VOLTAREN 50 MG SUP 10'S,Medicine,Rayan Hospital,RYN_IP,,,,1118285034,15-01-2024,19.9,-3.98,644988.0,BOX,Issue to Patient,0.2,12.54252,-2.5085,3.1007,38.89058
6560020099,VOLTAREN 50 MG SUP 10'S,Medicine,Rayan Hospital,RYN_IP,,,,1118328759,15-01-2024,19.9,-5.97,644990.0,BOX,Issue to Patient,0.2999,12.54252,-3.7615,2.8008,35.12908
6560020099,VOLTAREN 50 MG SUP 10'S,Medicine,Rayan Hospital,RYN_IP,,,,1118829157,16-01-2024,19.9,-1.99,644988.0,BOX,Issue to Patient,0.1,12.54252,-1.25425,3.0008,37.63758
6560020099,VOLTAREN 50 MG SUP 10'S,Medicine,Rayan Hospital,RYN_IP,,,,1119402273,17-01-2024,19.9,-1.99,644988.0,BOX,Issue to Patient,0.1,12.54252,-1.25425,2.9008,36.38333
6560020099,VOLTAREN 50 MG SUP 10'S,Medicine,Rayan Hospital,RYN_IP,,,,1119439939,17-01-2024,19.9,-1.99,644988.0,BOX,Issue to Patient,0.1,12.54252,-1.25425,2.8008,35.12908
6560020099,VOLTAREN 50 MG SUP 10'S,Medicine,Rayan Hospital,RYN_IP,,,,1119497593,17-01-2024,19.9,-3.98,644990.0,BOX,Issue to Patient,0.2,12.54252,-2.5085,2.6008,32.62058
6560020099,VOLTAREN 50 MG SUP 10'S,Medicine,Rayan Hospital,RYN_IP,,,,1119515755,17-01-2024,19.9,-3.98,644988.0,BOX,Issue to Patient,0.2,12.54252,-2.5085,2.4008,30.11207
6560020099,VOLTAREN 50 MG SUP 10'S,Medicine,Rayan Hospital,RYN_IP,,,,1119516032,17-01-2024,19.9,-3.98,644988.0,BOX,Issue to Patient,0.2,12.54252,-2.5085,2.2008,27.60357
6560020099,VOLTAREN 50 MG SUP 10'S,Medicine,Rayan Hospital,RYN_IP,,,,1120041572,18-01-2024,19.9,-1.99,644988.0,BOX,Issue to Patient,0.1,12.54252,-1.25425,2.4008,30.11207
6560020099,VOLTAREN 50 MG SUP 10'S,Medicine,Rayan Hospital,RYN_IP,,,,1120064616,18-01-2024,19.9,-3.98,644988.0,BOX,Issue to Patient,0.2,12.54252,-2.5085,2.2008,27.60357
6560020099,VOLTAREN 50 MG SUP 10'S,Medicine,Rayan Hospital,RYN_IP,,,,1120087760,18-01-2024,19.9,-1.99,644990.0,BOX,Issue to Patient,0.1,12.54252,-1.25425,2.1008,26.34932
6560020099,VOLTAREN 50 MG SUP 10'S,Medicine,Rayan Hospital,RYN_IP,,,,1120128737,18-01-2024,19.9,-1.99,644988.0,BOX,Issue to Patient,0.1,12.54252,-1.25425,2.0008,25.09507
6560020099,VOLTAREN 50 MG SUP 10'S,Medicine,Rayan Hospital,RYN_IP,,,,1120180500,18-01-2024,19.9,-1.99,644990.0,BOX,Issue to Patient,0.1,12.54252,-1.25425,2.0008,25.09507
6560020099,VOLTAREN 50 MG SUP 10'S,Medicine,Rayan Hospital,RYN_IP,,,,1121255728,20-01-2024,19.9,-5.97,644990.0,BOX,Issue to Patient,0.2999,12.54252,-3.7615,1.7009,21.33357
6560020099,VOLTAREN 50 MG SUP 10'S,Medicine,Rayan Hospital,RYN_IP,,,,1121420932,21-01-2024,19.9,-1.99,644988.0,BOX,Issue to Patient,0.1,12.54252,-1.25425,1.6009,20.07931
6560020099,VOLTAREN 50 MG SUP 10'S,Medicine,Rayan Hospital,RYN_IP,,,,1121436206,21-01-2024,19.9,-3.98,644988.0,BOX,Issue to Patient,0.2,12.54252,-2.5085,1.4009,17.57081
6560020099,VOLTAREN 50 MG SUP 10'S,Medicine,Rayan Hospital,RYN_IP,,,,1121437696,21-01-2024,19.9,-5.97,644988.0,BOX,Issue to Patient,0.2999,12.54252,-3.7615,1.101,13.80931
6560020099,VOLTAREN 50 MG SUP 10'S,Medicine,Rayan Hospital,RYN_IP,,,,1122034494,22-01-2024,19.9,-1.99,644990.0,BOX,Issue to Patient,0.1,12.54252,-1.25425,1.001,12.55506
6560020099,VOLTAREN 50 MG SUP 10'S,Medicine,Rayan Hospital,RYN_IP,,,,1122057448,22-01-2024,19.9,-1.99,644990.0,BOX,Issue to Patient,0.1,12.54252,-1.25425,0.901,11.30081
6560020099,VOLTAREN 50 MG SUP 10'S,Medicine,Rayan Hospital,RYN_IP,,,,1122128761,22-01-2024,19.9,-3.98,644990.0,BOX,Issue to Patient,0.2,12.54252,-2.5085,0.701,8.7923
6560020099,VOLTAREN 50 MG SUP 10'S,Medicine,Rayan Hospital,RYN_IP,,,,1122129070,22-01-2024,19.9,-3.98,644990.0,BOX,Issue to Patient,0.2,12.54252,-2.5085,0.501,6.2838
6560020099,VOLTAREN 50 MG SUP 10'S,Medicine,Rayan Hospital,RYN_IP,,,,1122129197,22-01-2024,19.9,-5.97,644988.0,BOX,Issue to Patient,0.2999,12.54252,-3.7615,0.2011,2.5223
6560020099,VOLTAREN 50 MG SUP 10'S,Medicine,Rayan Hospital,RYN_IP,,,,1122627885,23-01-2024,19.9,-1.99,644990.0,BOX,Issue to Patient,0.1,12.54252,-1.25425,0.5011,6.28505
6560020099,VOLTAREN 50 MG SUP 10'S,Medicine,Rayan Hospital,RYN_IP,,,,1122689006,23-01-2024,19.9,-3.98,644990.0,BOX,Issue to Patient,0.2,12.54252,-2.5085,0.3011,3.77655
6560020099,VOLTAREN 50 MG SUP 10'S,Medicine,Rayan Hospital,RYN_IP,,,,1123232245,24-01-2024,19.9,-1.99,644990.0,BOX,Issue to Patient,0.1,12.54252,-1.25425,5.2011,65.23488
6560020099,VOLTAREN 50 MG SUP 10'S,Medicine,Rayan Hospital,RYN_IP,,,,1123282029,24-01-2024,19.9,-3.98,644990.0,BOX,Issue to Patient,0.2,12.54252,-2.5085,5.0011,62.72638
6560020099,VOLTAREN 50 MG SUP 10'S,Medicine,Rayan Hospital,RYN_IP,,,,1123288087,24-01-2024,19.9,-5.97,644990.0,BOX,Issue to Patient,0.2999,12.54252,-3.7615,4.7012,58.96488
6560020099,VOLTAREN 50 MG SUP 10'S,Medicine,Rayan Hospital,RAY_ENSCPY,RYN 11105-Endoscopy,,15499438,1123687467,24-01-2024,19.9,-1.99,644985.0,BOX,Move Order Issue,0.1,12.54252,-1.25425,4.7012,58.96488
6560020099,VOLTAREN 50 MG SUP 10'S,Medicine,Rayan Hospital,RYN_IP,,,,1123798169,25-01-2024,19.9,-1.99,644990.0,BOX,Issue to Patient,0.1,12.54252,-1.25425,4.6012,57.71063
6560020099,VOLTAREN 50 MG SUP 10'S,Medicine,Rayan Hospital,RYN_IP,,,,1123879151,25-01-2024,19.9,-5.97,644990.0,BOX,Issue to Patient,0.2999,12.54252,-3.7615,4.3013,53.94913
6560020099,VOLTAREN 50 MG SUP 10'S,Medicine,Rayan Hospital,RYN_IP,,,,1124995054,27-01-2024,19.9,-1.99,644990.0,BOX,Issue to Patient,0.1,12.54252,-1.25425,4.3013,53.94913
6560020099,VOLTAREN 50 MG SUP 10'S,Medicine,Rayan Hospital,RYN_IP,,,,1125191373,28-01-2024,19.9,-1.99,644990.0,BOX,Issue to Patient,0.1,12.54252,-1.25425,4.2013,52.69487
6560020099,VOLTAREN 50 MG SUP 10'S,Medicine,Rayan Hospital,RYN_IP,,,,1125276853,28-01-2024,19.9,-3.98,644990.0,BOX,Issue to Patient,0.2,12.54252,-2.5085,4.0013,50.18637
6560020099,VOLTAREN 50 MG SUP 10'S,Medicine,Rayan Hospital,RYN_IP,,,,1125840994,29-01-2024,19.9,-1.99,644990.0,BOX,Issue to Patient,0.1,12.54252,-1.25425,4.1013,51.44062
6560020099,VOLTAREN 50 MG SUP 10'S,Medicine,Rayan Hospital,RYN_IP,,,,1125854133,29-01-2024,19.9,-3.98,644990.0,BOX,Issue to Patient,0.2,12.54252,-2.5085,3.9013,48.93212
6560020099,VOLTAREN 50 MG SUP 10'S,Medicine,Rayan Hospital,RYN_IP,,,,1127001356,31-01-2024,19.9,-1.99,644990.0,BOX,Issue to Patient,0.1,12.54252,-1.25425,6.8013,85.30542
6560020099,VOLTAREN 50 MG SUP 10'S,Medicine,Rayan Hospital,RYN_IP,,,,1127023240,31-01-2024,19.9,-1.99,644990.0,BOX,Issue to Patient,0.1,12.54252,-1.25425,6.7013,84.05116
6560020099,VOLTAREN 50 MG SUP 10'S,Medicine,Rayan Hospital,RYN_IP,,,,1127025722,31-01-2024,19.9,-3.98,644990.0,BOX,Issue to Patient,0.2,12.54252,-2.5085,6.5013,81.54266
6560020099,VOLTAREN 50 MG SUP 10'S,Medicine,Rayan Hospital,RYN_IP,,,,1127031959,31-01-2024,19.9,-3.98,644990.0,BOX,Issue to Patient,0.2,12.54252,-2.5085,6.3013,79.03416
6560020099,VOLTAREN 50 MG SUP 10'S,Medicine,Rayan Hospital,RYN_IP,,,,1128187771,02-02-2024,19.9,-3.98,644990.0,BOX,Issue to Patient,0.2,12.54252,-2.5085,6.4013,80.28841
6560020099,VOLTAREN 50 MG SUP 10'S,Medicine,Rayan Hospital,RYN_IP,,,,1128900657,04-02-2024,19.9,-1.99,644990.0,BOX,Issue to Patient,0.1,12.54252,-1.25425,6.3013,79.03416
6560020099,VOLTAREN 50 MG SUP 10'S,Medicine,Rayan Hospital,STAGE,Rayan Hospital Clinics,RAY_RCVRY,17497888,1128902020,04-02-2024,19.9,-9.95,644990.0,BOX,Int Order Direct Ship,0.5,12.54252,-6.27126,5.8013,72.7629
6560020099,VOLTAREN 50 MG SUP 10'S,Medicine,Rayan Hospital,RYN_IP,,,,1128935472,04-02-2024,19.9,-1.99,644990.0,BOX,Issue to Patient,0.1,12.54252,-1.25425,5.7013,71.50865
6560020099,VOLTAREN 50 MG SUP 10'S,Medicine,Rayan Hospital,RYN_IP,,,,1128988410,04-02-2024,19.9,-1.99,644985.0,BOX,Issue to Patient,0.1,12.54252,-1.25425,5.6013,70.2544
6560020099,VOLTAREN 50 MG SUP 10'S,Medicine,Rayan Hospital,RYN_IP,,,,1128988425,04-02-2024,19.9,-1.99,644990.0,BOX,Issue to Patient,0.1,12.54252,-1.25425,5.5013,69.00014
6560020099,VOLTAREN 50 MG SUP 10'S,Medicine,Rayan Hospital,RYN_IP,,,,1128988530,04-02-2024,19.9,-3.98,644990.0,BOX,Issue to Patient,0.2,12.54252,-2.5085,5.3013,66.49164
6560020099,VOLTAREN 50 MG SUP 10'S,Medicine,Rayan Hospital,RYN_IP,,,,1130163147,06-02-2024,19.9,-1.99,644990.0,BOX,Issue to Patient,0.1,12.54252,-1.25425,5.7013,71.50865
6560020099,VOLTAREN 50 MG SUP 10'S,Medicine,Rayan Hospital,RYN_IP,,,,1130235205,06-02-2024,19.9,-3.98,644990.0,BOX,Issue to Patient,0.2,12.54252,-2.5085,5.5013,69.00014
6560020099,VOLTAREN 50 MG SUP 10'S,Medicine,Rayan Hospital,RYN_IP,,,,1132762851,11-02-2024,19.9,-1.99,644990.0,BOX,Issue to Patient,0.1,12.54252,-1.25425,13.6013,170.59453
6560020099,VOLTAREN 50 MG SUP 10'S,Medicine,Rayan Hospital,RYN_IP,,,,1132792114,11-02-2024,19.9,-1.99,644990.0,BOX,Issue to Patient,0.1,12.54252,-1.25425,13.5013,169.34028
6560020099,VOLTAREN 50 MG SUP 10'S,Medicine,Rayan Hospital,RYN_IP,,,,1132804229,11-02-2024,19.9,-3.98,644990.0,BOX,Issue to Patient,0.2,12.54252,-2.5085,13.3013,166.83177
6560020099,VOLTAREN 50 MG SUP 10'S,Medicine,Rayan Hospital,RYN_IP,,,,1132826064,11-02-2024,19.9,-3.98,644990.0,BOX,Issue to Patient,0.2,12.54252,-2.5085,13.1013,164.32327
6560020099,VOLTAREN 50 MG SUP 10'S,Medicine,Rayan Hospital,RYN_IP,,,,1133363388,12-02-2024,19.9,-1.99,644990.0,BOX,Issue to Patient,0.1,12.54252,-1.25425,13.0013,163.06902
6560020099,VOLTAREN 50 MG SUP 10'S,Medicine,Rayan Hospital,RYN_IP,,,,1133394567,12-02-2024,19.9,-3.98,644990.0,BOX,Issue to Patient,0.2,12.54252,-2.5085,12.8013,160.56051
6560020099,VOLTAREN 50 MG SUP 10'S,Medicine,Rayan Hospital,RYN_IP,,,,1133611954,12-02-2024,19.9,-3.98,644990.0,BOX,Issue to Patient,0.2,12.54252,-2.5085,12.6013,158.05201
6560020099,VOLTAREN 50 MG SUP 10'S,Medicine,Rayan Hospital,RYN_IP,,,,1133954398,13-02-2024,19.9,-1.99,644990.0,BOX,Issue to Patient,0.1,12.54252,-1.25425,13.0013,163.06902
6560020099,VOLTAREN 50 MG SUP 10'S,Medicine,Rayan Hospital,RYN_IP,,,,1133980625,13-02-2024,19.9,-1.99,644990.0,BOX,Issue to Patient,0.1,12.54252,-1.25425,12.9013,161.81477
6560020099,VOLTAREN 50 MG SUP 10'S,Medicine,Rayan Hospital,RYN_IP,,,,1133990357,13-02-2024,19.9,-3.98,644990.0,BOX,Issue to Patient,0.2,12.54252,-2.5085,12.7013,159.30626
6560020099,VOLTAREN 50 MG SUP 10'S,Medicine,Rayan Hospital,RYN_IP,,,,1133992704,13-02-2024,19.9,-3.98,644990.0,BOX,Issue to Patient,0.2,12.54252,-2.5085,12.5013,156.79776
6560020099,VOLTAREN 50 MG SUP 10'S,Medicine,Rayan Hospital,RYN_IP,,,,1134021186,13-02-2024,19.9,-5.97,644990.0,BOX,Issue to Patient,0.2999,12.54252,-3.7615,12.2014,153.03626
6560020099,VOLTAREN 50 MG SUP 10'S,Medicine,Rayan Hospital,RYN_IP,,,,1135235793,15-02-2024,19.9,-3.98,644990.0,BOX,Issue to Patient,0.2,12.54252,-2.5085,12.4013,155.54351
6560020099,VOLTAREN 50 MG SUP 10'S,Medicine,Rayan Hospital,RYN_IP,,,,1135598335,15-02-2024,19.9,-3.98,644990.0,BOX,Issue to Patient,0.2,12.54252,-2.5085,12.2013,153.035
6560020099,VOLTAREN 50 MG SUP 10'S,Medicine,Rayan Hospital,RYN_IP,,,,1135728737,16-02-2024,19.9,-3.98,644990.0,BOX,Issue to Patient,0.2,12.54252,-2.5085,12.0013,150.5265
6560020099,VOLTAREN 50 MG SUP 10'S,Medicine,Rayan Hospital,RYN_IP,,,,1135750191,16-02-2024,19.9,-3.98,644990.0,BOX,Issue to Patient,0.2,12.54252,-2.5085,11.8013,148.018
6560020099,VOLTAREN 50 MG SUP 10'S,Medicine,Rayan Hospital,RYN_IP,,,,1136000240,17-02-2024,19.9,-3.98,644990.0,BOX,Issue to Patient,0.2,12.54252,-2.5085,11.8013,148.018
6560020099,VOLTAREN 50 MG SUP 10'S,Medicine,Rayan Hospital,RYN_IP,,,,1136107385,17-02-2024,19.9,-1.99,644990.0,BOX,Issue to Patient,0.1,12.54252,-1.25425,11.7013,146.76375
6560020099,VOLTAREN 50 MG SUP 10'S,Medicine,Rayan Hospital,RYN_IP,,,,1136248097,17-02-2024,19.9,-3.98,644990.0,BOX,Issue to Patient,0.2,12.54252,-2.5085,11.5013,144.25524
6560020099,VOLTAREN 50 MG SUP 10'S,Medicine,Rayan Hospital,RYN_IP,,,,1136535002,18-02-2024,19.9,-1.99,644990.0,BOX,Issue to Patient,0.1,12.54252,-1.25425,11.7013,146.76375
6560020099,VOLTAREN 50 MG SUP 10'S,Medicine,Rayan Hospital,RYN_IP,,,,1136576349,18-02-2024,19.9,-1.99,644990.0,BOX,Issue to Patient,0.1,12.54252,-1.25425,11.6013,145.50949
6560020099,VOLTAREN 50 MG SUP 10'S,Medicine,Rayan Hospital,RYN_IP,,,,1136577278,18-02-2024,19.9,-3.98,644990.0,BOX,Issue to Patient,0.2,12.54252,-2.5085,11.4013,143.00099
6560020099,VOLTAREN 50 MG SUP 10'S,Medicine,Rayan Hospital,RYN_IP,,,,1136648150,18-02-2024,19.9,-3.98,644990.0,BOX,Issue to Patient,0.2,12.54252,-2.5085,11.2013,140.49249
6560020099,VOLTAREN 50 MG SUP 10'S,Medicine,Rayan Hospital,RYN_IP,,,,1137117557,19-02-2024,19.9,-1.99,644990.0,BOX,Issue to Patient,0.1,12.54252,-1.25425,11.1013,139.23824
6560020099,VOLTAREN 50 MG SUP 10'S,Medicine,Rayan Hospital,RYN_IP,,,,1137150389,19-02-2024,19.9,-3.98,644990.0,BOX,Issue to Patient,0.2,12.54252,-2.5085,10.9013,136.72973
6560020099,VOLTAREN 50 MG SUP 10'S,Medicine,Rayan Hospital,RYN_IP,,,,1137150779,19-02-2024,19.9,-1.99,644990.0,BOX,Issue to Patient,0.1,12.54252,-1.25425,10.8013,135.47548
6560020099,VOLTAREN 50 MG SUP 10'S,Medicine,Rayan Hospital,RYN_IP,,,,1137227594,19-02-2024,19.9,-3.98,644990.0,BOX,Issue to Patient,0.2,12.54252,-2.5085,10.6013,132.96698
6560020099,VOLTAREN 50 MG SUP 10'S,Medicine,Rayan Hospital,RYN_IP,,,,1137328575,19-02-2024,19.9,-1.99,644990.0,BOX,Issue to Patient,0.1,12.54252,-1.25425,10.5013,131.71273
6560020099,VOLTAREN 50 MG SUP 10'S,Medicine,Rayan Hospital,RYN_IP,,,,1138311584,21-02-2024,19.9,-1.99,644990.0,BOX,Issue to Patient,0.1,12.54252,-1.25425,10.6013,132.96698
6560020099,VOLTAREN 50 MG SUP 10'S,Medicine,Rayan Hospital,RYN_IP,,,,1138365029,21-02-2024,19.9,-3.98,644990.0,BOX,Issue to Patient,0.2,12.54252,-2.5085,10.4013,130.45847
6560020099,VOLTAREN 50 MG SUP 10'S,Medicine,Rayan Hospital,RYN_IP,,,,1138889211,22-02-2024,19.9,-1.99,644990.0,BOX,Issue to Patient,0.1,12.54252,-1.25425,10.3013,129.20422
6560020099,VOLTAREN 50 MG SUP 10'S,Medicine,Rayan Hospital,RYN_IP,,,,1138920945,22-02-2024,19.9,-1.99,644990.0,BOX,Issue to Patient,0.1,12.54252,-1.25425,10.2013,127.94997
6560020099,VOLTAREN 50 MG SUP 10'S,Medicine,Rayan Hospital,RYN_IP,,,,1138929121,22-02-2024,19.9,-3.98,644990.0,BOX,Issue to Patient,0.2,12.54252,-2.5085,10.0013,125.44147
6560020099,VOLTAREN 50 MG SUP 10'S,Medicine,Rayan Hospital,RYN_IP,,,,1138929126,22-02-2024,19.9,-3.98,644990.0,BOX,Issue to Patient,0.2,12.54252,-2.5085,9.8013,122.93296
6560020099,VOLTAREN 50 MG SUP 10'S,Medicine,Rayan Hospital,RYN_IP,,,,1140080151,25-02-2024,19.9,-1.99,644990.0,BOX,Issue to Patient,0.1,12.54252,-1.25425,10.2013,127.94997
6560020099,VOLTAREN 50 MG SUP 10'S,Medicine,Rayan Hospital,RYN_IP,,,,1140102877,25-02-2024,19.9,-1.99,644990.0,BOX,Issue to Patient,0.1,12.54252,-1.25425,10.1013,126.69572
6560020099,VOLTAREN 50 MG SUP 10'S,Medicine,Rayan Hospital,RYN_IP,,,,1140113146,25-02-2024,19.9,-3.98,644990.0,BOX,Issue to Patient,0.2,12.54252,-2.5085,9.9013,124.18722
6560020099,VOLTAREN 50 MG SUP 10'S,Medicine,Rayan Hospital,RYN_IP,,,,1140131621,25-02-2024,19.9,-3.98,644990.0,BOX,Issue to Patient,0.2,12.54252,-2.5085,9.7013,121.67871
6560020099,VOLTAREN 50 MG SUP 10'S,Medicine,Rayan Hospital,RYN_IP,,,,1140710214,26-02-2024,19.9,-3.98,644990.0,BOX,Issue to Patient,0.2,12.54252,-2.5085,9.5013,119.17021
6560020099,VOLTAREN 50 MG SUP 10'S,Medicine,Rayan Hospital,RYN_IP,,,,1140714786,26-02-2024,19.9,-3.98,644990.0,BOX,Issue to Patient,0.2,12.54252,-2.5085,9.3013,116.66171
6560020099,VOLTAREN 50 MG SUP 10'S,Medicine,Rayan Hospital,RYN_IP,,,,1141921688,28-02-2024,19.9,-1.99,644990.0,BOX,Issue to Patient,0.1,12.54252,-1.25425,9.2013,115.40746
6560020099,VOLTAREN 50 MG SUP 10'S,Medicine,Rayan Hospital,RYN_IP,,,,1141948804,28-02-2024,19.9,-3.98,644990.0,BOX,Issue to Patient,0.2,12.54252,-2.5085,9.0013,112.89895
6560020099,VOLTAREN 50 MG SUP 10'S,Medicine,Rayan Hospital,RYN_IP,,,,1142444284,29-02-2024,19.9,-3.98,644990.0,BOX,Issue to Patient,0.2,12.54252,-2.5085,8.8013,110.39045
6560020099,VOLTAREN 50 MG SUP 10'S,Medicine,Rayan Hospital,RYN_IP,,,,1142444294,29-02-2024,19.9,-3.98,644990.0,BOX,Issue to Patient,0.2,12.54252,-2.5085,8.6013,107.88195
6560020099,VOLTAREN 50 MG SUP 10'S,Medicine,Rayan Hospital,RYN_IP,,,,1142457321,29-02-2024,19.9,-3.98,644990.0,BOX,Issue to Patient,0.2,12.54252,-2.5085,8.4013,105.37344
6560020099,VOLTAREN 50 MG SUP 10'S,Medicine,Rayan Hospital,RYN_IP,,,,1143348712,02-03-2024,19.9,-3.98,644990.0,BOX,Issue to Patient,0.2,12.54252,-2.5085,8.5013,106.62769
6560020099,VOLTAREN 50 MG SUP 10'S,Medicine,Rayan Hospital,RYN_IP,,,,1144353288,04-03-2024,19.9,-1.99,644990.0,BOX,Issue to Patient,0.1,12.54252,-1.25425,8.5013,106.62769
6560020099,VOLTAREN 50 MG SUP 10'S,Medicine,Rayan Hospital,RYN_IP,,,,1144384236,04-03-2024,19.9,-1.99,644990.0,BOX,Issue to Patient,0.1,12.54252,-1.25425,8.4013,105.37344
6560020099,VOLTAREN 50 MG SUP 10'S,Medicine,Rayan Hospital,RYN_IP,,,,1144393944,04-03-2024,19.9,-3.98,644990.0,BOX,Issue to Patient,0.2,12.54252,-2.5085,8.2013,102.86494
6560020099,VOLTAREN 50 MG SUP 10'S,Medicine,Rayan Hospital,RYN_IP,,,,1144397554,04-03-2024,19.9,-3.98,644990.0,BOX,Issue to Patient,0.2,12.54252,-2.5085,8.0013,100.35644
6560020099,VOLTAREN 50 MG SUP 10'S,Medicine,Rayan Hospital,RYN_IP,,,,1144404848,04-03-2024,19.9,-5.97,644990.0,BOX,Issue to Patient,0.2999,12.54252,-3.7615,7.7014,96.59493
6560020099,VOLTAREN 50 MG SUP 10'S,Medicine,Rayan Hospital,RYN_IP,,,,1144681861,04-03-2024,19.9,-5.97,644990.0,BOX,Issue to Patient,0.2999,12.54252,-3.7615,7.4015,92.83343
6560020099,VOLTAREN 50 MG SUP 10'S,Medicine,Rayan Hospital,RYN_IP,,,,1144997482,05-03-2024,19.9,-1.99,644990.0,BOX,Issue to Patient,0.1,12.54252,-1.25425,7.7015,96.59619
6560020099,VOLTAREN 50 MG SUP 10'S,Medicine,Rayan Hospital,RYN_IP,,,,1145052360,05-03-2024,19.9,-1.99,644990.0,BOX,Issue to Patient,0.1,12.54252,-1.25425,7.6015,95.34194
6560020099,VOLTAREN 50 MG SUP 10'S,Medicine,Rayan Hospital,RYN_IP,,,,1145625861,06-03-2024,19.9,-1.99,644990.0,BOX,Issue to Patient,0.1,12.54252,-1.25425,7.8015,97.85044
6560020099,VOLTAREN 50 MG SUP 10'S,Medicine,Rayan Hospital,RYN_IP,,,,1145654226,06-03-2024,19.9,-3.98,644990.0,BOX,Issue to Patient,0.2,12.54252,-2.5085,7.6015,95.34194
6560020099,VOLTAREN 50 MG SUP 10'S,Medicine,Rayan Hospital,RYN_IP,,,,1145670181,06-03-2024,19.9,-3.98,644990.0,BOX,Issue to Patient,0.2,12.54252,-2.5085,7.4015,92.83343
6560020099,VOLTAREN 50 MG SUP 10'S,Medicine,Rayan Hospital,RYN_IP,,,,1145894923,06-03-2024,19.9,-3.98,644990.0,BOX,Issue to Patient,0.2,12.54252,-2.5085,7.2015,90.32493
6560020099,VOLTAREN 50 MG SUP 10'S,Medicine,Rayan Hospital,RYN_IP,,,,1147690308,10-03-2024,19.9,-1.99,644990.0,BOX,Issue to Patient,0.1,12.54252,-1.25425,7.4015,92.83343
6560020099,VOLTAREN 50 MG SUP 10'S,Medicine,Rayan Hospital,RYN_IP,,,,1147734659,10-03-2024,19.9,-3.98,644990.0,BOX,Issue to Patient,0.2,12.54252,-2.5085,7.2015,90.32493
6560020099,VOLTAREN 50 MG SUP 10'S,Medicine,Rayan Hospital,RYN_IP,,,,1148368094,11-03-2024,19.9,-1.99,644990.0,BOX,Issue to Patient,0.1,12.54252,-1.25425,7.4014,92.83218
6560020099,VOLTAREN 50 MG SUP 10'S,Medicine,Rayan Hospital,RYN_IP,,,,1148691384,11-03-2024,19.9,-1.99,644990.0,BOX,Issue to Patient,0.1,12.54252,-1.25425,7.3014,91.57793
6560020099,VOLTAREN 50 MG SUP 10'S,Medicine,Rayan Hospital,RYN_IP,,,,1149239984,13-03-2024,19.9,-3.98,644990.0,BOX,Issue to Patient,0.2,12.54252,-2.5085,7.1014,89.06943
6560020099,VOLTAREN 50 MG SUP 10'S,Medicine,Rayan Hospital,RYN_IP,,,,1149327378,13-03-2024,19.9,-3.98,644990.0,BOX,Issue to Patient,0.2,12.54252,-2.5085,6.9014,86.56092
6560020099,VOLTAREN 50 MG SUP 10'S,Medicine,Rayan Hospital,RYN_IP,,,,1149330438,13-03-2024,19.9,-1.99,644990.0,BOX,Issue to Patient,0.1,12.54252,-1.25425,6.8014,85.30667
6560020099,VOLTAREN 50 MG SUP 10'S,Medicine,Rayan Hospital,RYN_IP,,,,1149330759,13-03-2024,19.9,-3.98,644990.0,BOX,Issue to Patient,0.2,12.54252,-2.5085,6.6014,82.79817
6560020099,VOLTAREN 50 MG SUP 10'S,Medicine,Rayan Hospital,RYN_IP,,,,1149878746,14-03-2024,19.9,-3.98,644990.0,BOX,Issue to Patient,0.2,12.54252,-2.5085,6.7014,84.05242
6560020099,VOLTAREN 50 MG SUP 10'S,Medicine,Rayan Hospital,RYN_IP,,,,1150380123,15-03-2024,19.9,-3.98,644990.0,BOX,Issue to Patient,0.2,12.54252,-2.5085,6.9014,86.56092
6560020099,VOLTAREN 50 MG SUP 10'S,Medicine,Rayan Hospital,RYN_IP,,,,1150472668,16-03-2024,19.9,-3.98,644990.0,BOX,Issue to Patient,0.2,12.54252,-2.5085,6.7014,84.05242
6560020099,VOLTAREN 50 MG SUP 10'S,Medicine,Rayan Hospital,RYN_IP,,,,1155596980,26-03-2024,19.9,-3.98,644990.0,BOX,Issue to Patient,0.2,12.54252,-2.5085,6.7014,84.05242
6560020099,VOLTAREN 50 MG SUP 10'S,Medicine,Rayan Hospital,STAGE,Rayan Hospital Clinics,RAY_RCVRY,17533527,1156377119,27-03-2024,19.9,-0.02,644988.0,BOX,Int Order Direct Ship,0.0008,12.54252,-0.01003,6.7006,84.04238
6560020099,VOLTAREN 50 MG SUP 10'S,Medicine,Rayan Hospital,STAGE,Rayan Hospital Clinics,RAY_RCVRY,17533527,1156377122,27-03-2024,19.9,-39.78,644990.0,BOX,Int Order Direct Ship,1.9992,12.54252,-25.075,4.7014,58.96739
6560020099,VOLTAREN 50 MG SUP 10'S,Medicine,Rayan Hospital,RYN_IP,,,,1156673942,28-03-2024,19.9,-1.99,644990.0,BOX,Issue to Patient,0.1,12.54252,-1.25425,4.6014,57.71313
6560020099,VOLTAREN 50 MG SUP 10'S,Medicine,Rayan Hospital,RYN_IP,,,,1156691625,28-03-2024,19.9,-3.98,644990.0,BOX,Issue to Patient,0.2,12.54252,-2.5085,4.4014,55.20463
6560020099,VOLTAREN 50 MG SUP 10'S,Medicine,Rayan Hospital,RYN_IP,,,,1157524311,30-03-2024,19.9,-3.98,644990.0,BOX,Issue to Patient,0.2,12.54252,-2.5085,4.2014,52.69613
6560020099,VOLTAREN 50 MG SUP 10'S,Medicine,Rayan Hospital,RYN_IP,,,,1157853524,31-03-2024,19.9,-1.99,644990.0,BOX,Issue to Patient,0.1,12.54252,-1.25425,4.1014,51.44188
6560020099,VOLTAREN 50 MG SUP 10'S,Medicine,Rayan Hospital,STAGE,Rayan Hospital Clinics,RAY_ER,17532620,1157888032,31-03-2024,19.9,-19.9,644990.0,BOX,Int Order Direct Ship,1.0,12.54252,-12.54252,3.1014,38.89936
6560020099,VOLTAREN 50 MG SUP 10'S,Medicine,Rayan Hospital,RYN_IP,,,,1159426402,03-04-2024,19.9,-1.99,644990.0,BOX,Issue to Patient,0.1,12.54252,-1.25425,3.1014,38.89936
6560020099,VOLTAREN 50 MG SUP 10'S,Medicine,Rayan Hospital,RYN_IP,,,,1159427151,03-04-2024,19.9,-3.98,644990.0,BOX,Issue to Patient,0.2,12.54252,-2.5085,2.9014,36.39086
6560020099,VOLTAREN 50 MG SUP 10'S,Medicine,Rayan Hospital,RYN_IP,,,,1159448566,03-04-2024,19.9,-5.97,644990.0,BOX,Issue to Patient,0.2999,12.54252,-3.7615,2.6015,32.62936
6560020099,VOLTAREN 50 MG SUP 10'S,Medicine,Rayan Hospital,RYN_IP,,,,1159900093,04-04-2024,19.9,-3.98,644990.0,BOX,Issue to Patient,0.2,12.54252,-2.5085,2.4015,30.12085
6560020099,VOLTAREN 50 MG SUP 10'S,Medicine,Rayan Hospital,RYN_IP,,,,1165408027,19-04-2024,19.9,-1.99,644991.0,BOX,Issue to Patient,0.1,12.54252,-1.25425,7.5015,94.08769
6560020099,VOLTAREN 50 MG SUP 10'S,Medicine,Rayan Hospital,RYN_IP,,,,1165427453,19-04-2024,19.9,-3.98,644990.0,BOX,Issue to Patient,0.2,12.54252,-2.5085,7.3015,91.57918
6560020099,VOLTAREN 50 MG SUP 10'S,Medicine,Rayan Hospital,RYN_IP,,,,1168275835,24-04-2024,19.9,-3.98,644991.0,BOX,Issue to Patient,0.2,12.54252,-2.5085,7.4015,92.83343
6560020099,VOLTAREN 50 MG SUP 10'S,Medicine,Rayan Hospital,RYN_IP,,,,1168389895,24-04-2024,19.9,-1.99,644991.0,BOX,Issue to Patient,0.1,12.54252,-1.25425,7.3015,91.57918
6560020099,VOLTAREN 50 MG SUP 10'S,Medicine,Rayan Hospital,RYN_IP,,,,1168574638,25-04-2024,19.9,-1.99,644990.0,BOX,Issue to Patient,0.1,12.54252,-1.25425,7.2015,90.32493
6560020099,VOLTAREN 50 MG SUP 10'S,Medicine,Rayan Hospital,RYN_IP,,,,1168597603,25-04-2024,19.9,-1.99,644991.0,BOX,Issue to Patient,0.1,12.54252,-1.25425,7.1015,89.07068
6560020099,VOLTAREN 50 MG SUP 10'S,Medicine,Rayan Hospital,RYN_IP,,,,1168598113,25-04-2024,19.9,-1.99,644991.0,BOX,Issue to Patient,0.1,12.54252,-1.25425,7.0015,87.81643
6560020099,VOLTAREN 50 MG SUP 10'S,Medicine,Rayan Hospital,RYN_IP,,,,1168626731,25-04-2024,19.9,-3.98,644990.0,BOX,Issue to Patient,0.2,12.54252,-2.5085,6.8015,85.30792
6560020099,VOLTAREN 50 MG SUP 10'S,Medicine,Rayan Hospital,RYN_IP,,,,1168632247,25-04-2024,19.9,-1.99,644991.0,BOX,Issue to Patient,0.1,12.54252,-1.25425,6.7015,84.05367
6560020099,VOLTAREN 50 MG SUP 10'S,Medicine,Rayan Hospital,RYN_IP,,,,1168634829,25-04-2024,19.9,-1.99,644991.0,BOX,Issue to Patient,0.1,12.54252,-1.25425,6.6015,82.79942
6560020099,VOLTAREN 50 MG SUP 10'S,Medicine,Rayan Hospital,RYN_IP,,,,1168652488,25-04-2024,19.9,-3.98,644990.0,BOX,Issue to Patient,0.2,12.54252,-2.5085,6.4015,80.29092
6560020099,VOLTAREN 50 MG SUP 10'S,Medicine,Rayan Hospital,RYN_IP,,,,1168681022,25-04-2024,19.9,-5.97,644991.0,BOX,Issue to Patient,0.2999,12.54252,-3.7615,6.1016,76.52942
6560020099,VOLTAREN 50 MG SUP 10'S,Medicine,Rayan Hospital,RYN_IP,,,,1168720257,25-04-2024,19.9,-3.98,644990.0,BOX,Issue to Patient,0.2,12.54252,-2.5085,5.9016,74.02091
6560020099,VOLTAREN 50 MG SUP 10'S,Medicine,Rayan Hospital,RYN_IP,,,,1168720467,25-04-2024,19.9,-3.98,644990.0,BOX,Issue to Patient,0.2,12.54252,-2.5085,5.7016,71.51241
6560020099,VOLTAREN 50 MG SUP 10'S,Medicine,Rayan Hospital,RYN_IP,,,,1169497367,27-04-2024,19.9,-3.98,644991.0,BOX,Issue to Patient,0.2,12.54252,-2.5085,6.1016,76.52942
6560020099,VOLTAREN 50 MG SUP 10'S,Medicine,Rayan Hospital,RYN_IP,,,,1170006548,28-04-2024,19.9,-1.99,644991.0,BOX,Issue to Patient,0.1,12.54252,-1.25425,6.0016,75.27517
6560020099,VOLTAREN 50 MG SUP 10'S,Medicine,Rayan Hospital,RYN_IP,,,,1170134937,28-04-2024,19.9,-3.98,644990.0,BOX,Issue to Patient,0.2,12.54252,-2.5085,5.8016,72.76666
6560020099,VOLTAREN 50 MG SUP 10'S,Medicine,Rayan Hospital,RYN_IP,,,,1170644095,29-04-2024,19.9,-1.99,644991.0,BOX,Issue to Patient,0.1,12.54252,-1.25425,5.9016,74.02091
6560020099,VOLTAREN 50 MG SUP 10'S,Medicine,Rayan Hospital,RYN_IP,,,,1170674160,29-04-2024,19.9,-3.98,644990.0,BOX,Issue to Patient,0.2,12.54252,-2.5085,5.7016,71.51241
6560020099,VOLTAREN 50 MG SUP 10'S,Medicine,Rayan Hospital,RYN_IP,,,,1170831988,29-04-2024,19.9,-3.98,644991.0,BOX,Issue to Patient,0.2,12.54252,-2.5085,5.5016,69.00391
6560020099,VOLTAREN 50 MG SUP 10'S,Medicine,Rayan Hospital,RYN_IP,,,,1171002121,29-04-2024,19.9,-1.99,644991.0,BOX,Issue to Patient,0.1,12.54252,-1.25425,5.4016,67.74966
6560020099,VOLTAREN 50 MG SUP 10'S,Medicine,Rayan Hospital,RYN_IP,,,,1171168789,29-04-2024,19.9,-3.98,644991.0,BOX,Issue to Patient,0.2,12.54252,-2.5085,5.3016,66.4954
6560020099,VOLTAREN 50 MG SUP 10'S,Medicine,Rayan Hospital,RYN_IP,,,,1171255375,30-04-2024,19.9,-1.99,644991.0,BOX,Issue to Patient,0.1,12.54252,-1.25425,5.3016,66.4954
6560020099,VOLTAREN 50 MG SUP 10'S,Medicine,Rayan Hospital,RYN_IP,,,,1171323187,30-04-2024,19.9,-3.98,644990.0,BOX,Issue to Patient,0.2,12.54252,-2.5085,5.1016,63.9869
6560020099,VOLTAREN 50 MG SUP 10'S,Medicine,Rayan Hospital,RYN_IP,,,,1171380150,30-04-2024,19.9,-3.98,644990.0,BOX,Issue to Patient,0.2,12.54252,-2.5085,4.9016,61.4784
6560020099,VOLTAREN 50 MG SUP 10'S,Medicine,Rayan Hospital,RYN_IP,,,,1171520622,30-04-2024,19.9,-5.97,644991.0,BOX,Issue to Patient,0.2999,12.54252,-3.7615,4.6017,57.7169
6560020099,VOLTAREN 50 MG SUP 10'S,Medicine,Rayan Hospital,RYN_IP,,,,1171544758,30-04-2024,19.9,-3.98,644991.0,BOX,Issue to Patient,0.2,12.54252,-2.5085,4.6017,57.7169
6560020099,VOLTAREN 50 MG SUP 10'S,Medicine,Rayan Hospital,RYN_IP,,,,1171857083,01-05-2024,19.9,-1.99,644991.0,BOX,Issue to Patient,0.1,12.54252,-1.25425,4.5017,56.46265
6560020099,VOLTAREN 50 MG SUP 10'S,Medicine,Rayan Hospital,RYN_IP,,,,1171910560,01-05-2024,19.9,-3.98,644991.0,BOX,Issue to Patient,0.2,12.54252,-2.5085,4.6017,57.7169
6560020099,VOLTAREN 50 MG SUP 10'S,Medicine,Rayan Hospital,RYN_IP,,,,1172428430,02-05-2024,19.9,-1.99,644991.0,BOX,Issue to Patient,0.1,12.54252,-1.25425,4.7017,58.97115
6560020099,VOLTAREN 50 MG SUP 10'S,Medicine,Rayan Hospital,RYN_IP,,,,1172451771,02-05-2024,19.9,-1.99,644991.0,BOX,Issue to Patient,0.1,12.54252,-1.25425,4.6017,57.7169
6560020099,VOLTAREN 50 MG SUP 10'S,Medicine,Rayan Hospital,RYN_IP,,,,1172465142,02-05-2024,19.9,-3.98,644990.0,BOX,Issue to Patient,0.2,12.54252,-2.5085,4.4017,55.20839
6560020099,VOLTAREN 50 MG SUP 10'S,Medicine,Rayan Hospital,RYN_IP,,,,1172465172,02-05-2024,19.9,-3.98,644990.0,BOX,Issue to Patient,0.2,12.54252,-2.5085,4.2017,52.69989
6560020099,VOLTAREN 50 MG SUP 10'S,Medicine,Rayan Hospital,RYN_IP,,,,1172483058,02-05-2024,19.9,-5.97,644991.0,BOX,Issue to Patient,0.2999,12.54252,-3.7615,3.9018,48.93839
6560020099,VOLTAREN 50 MG SUP 10'S,Medicine,Rayan Hospital,RYN_IP,,,,1172649433,02-05-2024,19.9,-5.97,644991.0,BOX,Issue to Patient,0.2999,12.54252,-3.7615,3.6019,45.17689
6560020099,VOLTAREN 50 MG SUP 10'S,Medicine,Rayan Hospital,RYN_IP,,,,1173824431,05-05-2024,19.9,-1.99,644991.0,BOX,Issue to Patient,0.1,12.54252,-1.25425,4.1019,51.44815
6560020099,VOLTAREN 50 MG SUP 10'S,Medicine,Rayan Hospital,RYN_IP,,,,1173847635,05-05-2024,19.9,-1.99,644990.0,BOX,Issue to Patient,0.1,12.54252,-1.25425,4.0019,50.1939
6560020099,VOLTAREN 50 MG SUP 10'S,Medicine,Rayan Hospital,RYN_IP,,,,1173859450,05-05-2024,19.9,-3.98,644990.0,BOX,Issue to Patient,0.2,12.54252,-2.5085,3.8019,47.68539
6560020099,VOLTAREN 50 MG SUP 10'S,Medicine,Rayan Hospital,RYN_IP,,,,1173865335,05-05-2024,19.9,-3.98,644990.0,BOX,Issue to Patient,0.2,12.54252,-2.5085,3.6019,45.17689
6560020099,VOLTAREN 50 MG SUP 10'S,Medicine,Rayan Hospital,RYN_IP,,,,1173908511,05-05-2024,19.9,-1.99,644991.0,BOX,Issue to Patient,0.1,12.54252,-1.25425,3.5019,43.92264
6560020099,VOLTAREN 50 MG SUP 10'S,Medicine,Rayan Hospital,RYN_IP,,,,1174442179,06-05-2024,19.9,-1.99,644991.0,BOX,Issue to Patient,0.1,12.54252,-1.25425,3.8019,47.68539
6560020099,VOLTAREN 50 MG SUP 10'S,Medicine,Rayan Hospital,RYN_IP,,,,1174469059,06-05-2024,19.9,-3.98,644990.0,BOX,Issue to Patient,0.2,12.54252,-2.5085,3.6019,45.17689
6560020099,VOLTAREN 50 MG SUP 10'S,Medicine,Rayan Hospital,RYN_IP,,,,1174605854,06-05-2024,19.9,-3.98,644991.0,BOX,Issue to Patient,0.2,12.54252,-2.5085,3.4019,42.66839
6560020099,VOLTAREN 50 MG SUP 10'S,Medicine,Rayan Hospital,RYN_IP,,,,1176295868,09-05-2024,19.9,-1.99,644991.0,BOX,Issue to Patient,0.1,12.54252,-1.25425,3.5019,43.92264
6560020099,VOLTAREN 50 MG SUP 10'S,Medicine,Rayan Hospital,RYN_IP,,,,1176333054,09-05-2024,19.9,-1.99,644991.0,BOX,Issue to Patient,0.1,12.54252,-1.25425,3.4019,42.66839
6560020099,VOLTAREN 50 MG SUP 10'S,Medicine,Rayan Hospital,RYN_IP,,,,1176365525,09-05-2024,19.9,-3.98,644990.0,BOX,Issue to Patient,0.2,12.54252,-2.5085,3.2019,40.15988
6560020099,VOLTAREN 50 MG SUP 10'S,Medicine,Rayan Hospital,RYN_IP,,,,1176369316,09-05-2024,19.9,-3.98,644991.0,BOX,Issue to Patient,0.2,12.54252,-2.5085,3.0019,37.65138
6560020099,VOLTAREN 50 MG SUP 10'S,Medicine,Rayan Hospital,RYN_IP,,,,1176382097,09-05-2024,19.9,-3.98,644991.0,BOX,Issue to Patient,0.2,12.54252,-2.5085,2.8019,35.14288
6560020099,VOLTAREN 50 MG SUP 10'S,Medicine,Rayan Hospital,RYN_IP,,,,1176417016,09-05-2024,19.9,-5.97,644991.0,BOX,Issue to Patient,0.2999,12.54252,-3.7615,2.502,31.38138
6560020099,VOLTAREN 50 MG SUP 10'S,Medicine,Rayan Hospital,RYN_IP,,,,1177128349,11-05-2024,19.9,-5.97,644991.0,BOX,Issue to Patient,0.2999,12.54252,-3.7615,2.6021,32.63688
6560020099,VOLTAREN 50 MG SUP 10'S,Medicine,Rayan Hospital,RYN_IP,,,,1177193923,11-05-2024,19.9,-5.97,644991.0,BOX,Issue to Patient,0.2999,12.54252,-3.7615,2.3022,28.87538
6560020099,VOLTAREN 50 MG SUP 10'S,Medicine,Rayan Hospital,RYN_IP,,,,1177773761,12-05-2024,19.9,-5.97,644991.0,BOX,Issue to Patient,0.2999,12.54252,-3.7615,2.0023,25.11388
6560020099,VOLTAREN 50 MG SUP 10'S,Medicine,Rayan Hospital,RYN_IP,,,,1178356776,13-05-2024,19.9,-1.99,644991.0,BOX,Issue to Patient,0.1,12.54252,-1.25425,1.9023,23.85963
6560020099,VOLTAREN 50 MG SUP 10'S,Medicine,Rayan Hospital,RYN_IP,,,,1178368627,13-05-2024,19.9,-1.99,644991.0,BOX,Issue to Patient,0.1,12.54252,-1.25425,1.8023,22.60538
6560020099,VOLTAREN 50 MG SUP 10'S,Medicine,Rayan Hospital,RYN_IP,,,,1178413205,13-05-2024,19.9,-3.98,644991.0,BOX,Issue to Patient,0.2,12.54252,-2.5085,1.6023,20.09687
6560020099,VOLTAREN 50 MG SUP 10'S,Medicine,Rayan Hospital,RYN_IP,,,,1179040409,14-05-2024,19.9,-1.99,644991.0,BOX,Issue to Patient,0.1,12.54252,-1.25425,1.6023,20.09687
6560020099,VOLTAREN 50 MG SUP 10'S,Medicine,Rayan Hospital,RYN_IP,,,,1179066852,14-05-2024,19.9,-1.99,644991.0,BOX,Issue to Patient,0.1,12.54252,-1.25425,1.5023,18.84262
6560020099,VOLTAREN 50 MG SUP 10'S,Medicine,Rayan Hospital,RYN_IP,,,,1179069623,14-05-2024,19.9,-3.98,644991.0,BOX,Issue to Patient,0.2,12.54252,-2.5085,1.3023,16.33412
6560020099,VOLTAREN 50 MG SUP 10'S,Medicine,Rayan Hospital,RYN_IP,,,,1179069643,14-05-2024,19.9,-3.98,644991.0,BOX,Issue to Patient,0.2,12.54252,-2.5085,1.1023,13.82562
6560020099,VOLTAREN 50 MG SUP 10'S,Medicine,Rayan Hospital,RYN_IP,,,,1179684145,15-05-2024,19.9,-1.99,644991.0,BOX,Issue to Patient,0.1,12.54252,-1.25425,1.1023,13.82562
6560020099,VOLTAREN 50 MG SUP 10'S,Medicine,Rayan Hospital,RYN_IP,,,,1179797599,15-05-2024,19.9,-3.98,644991.0,BOX,Issue to Patient,0.2,12.54252,-2.5085,0.9023,11.31711
6560020099,VOLTAREN 50 MG SUP 10'S,Medicine,Rayan Hospital,RYN_IP,,,,1180343422,16-05-2024,19.9,-1.99,644991.0,BOX,Issue to Patient,0.1,12.54252,-1.25425,1.1023,13.82562
6560020099,VOLTAREN 50 MG SUP 10'S,Medicine,Rayan Hospital,RYN_IP,,,,1180378241,16-05-2024,19.9,-1.99,644991.0,BOX,Issue to Patient,0.1,12.54252,-1.25425,1.0023,12.57136
6560020099,VOLTAREN 50 MG SUP 10'S,Medicine,Rayan Hospital,RYN_IP,,,,1180388503,16-05-2024,19.9,-3.98,644991.0,BOX,Issue to Patient,0.2,12.54252,-2.5085,0.8023,10.06286
6560020099,VOLTAREN 50 MG SUP 10'S,Medicine,Rayan Hospital,RYN_IP,,,,1180392450,16-05-2024,19.9,-3.98,644991.0,BOX,Issue to Patient,0.2,12.54252,-2.5085,0.6023,7.55436
6560020099,VOLTAREN 50 MG SUP 10'S,Medicine,Rayan Hospital,RYN_IP,,,,1181211991,18-05-2024,19.9,-1.99,644991.0,BOX,Issue to Patient,0.1,12.54252,-1.25425,0.7023,8.80861
6560020099,VOLTAREN 50 MG SUP 10'S,Medicine,Rayan Hospital,RYN_IP,,,,1181228022,18-05-2024,19.9,-3.98,644991.0,BOX,Issue to Patient,0.2,12.54252,-2.5085,0.5023,6.30011
6560020099,VOLTAREN 50 MG SUP 10'S,Medicine,Rayan Hospital,RYN_IP,,,,1181850964,19-05-2024,19.9,-3.98,644991.0,BOX,Issue to Patient,0.2,12.54252,-2.5085,0.3023,3.7916
6560020099,VOLTAREN 50 MG SUP 10'S,Medicine,Rayan Hospital,RYN_IP,,,,1181853478,19-05-2024,19.9,-1.99,644991.0,BOX,Issue to Patient,0.1,12.54252,-1.25425,0.2023,2.53735
6560020099,VOLTAREN 50 MG SUP 10'S,Medicine,Rayan Hospital,RYN_IP,,,,1182481624,20-05-2024,19.9,-1.99,644992.0,BOX,Issue to Patient,0.1,12.54252,-1.25425,5.3023,66.50418
6560020099,VOLTAREN 50 MG SUP 10'S,Medicine,Rayan Hospital,RYN_IP,,,,1182510953,20-05-2024,19.9,-3.98,644991.0,BOX,Issue to Patient,0.2,12.54252,-2.5085,5.1023,63.99568
6560020099,VOLTAREN 50 MG SUP 10'S,Medicine,Rayan Hospital,RYN_IP,,,,1183133646,21-05-2024,19.9,-1.99,644992.0,BOX,Issue to Patient,0.1,12.54252,-1.25425,5.1023,63.99568
6560020099,VOLTAREN 50 MG SUP 10'S,Medicine,Rayan Hospital,RYN_IP,,,,1183173009,21-05-2024,19.9,-3.98,644992.0,BOX,Issue to Patient,0.2,12.54252,-2.5085,4.9023,61.48718
6560020099,VOLTAREN 50 MG SUP 10'S,Medicine,Rayan Hospital,RYN_IP,,,,1183763164,22-05-2024,19.9,-1.99,644992.0,BOX,Issue to Patient,0.1,12.54252,-1.25425,5.0023,62.74143
6560020099,VOLTAREN 50 MG SUP 10'S,Medicine,Rayan Hospital,RYN_IP,,,,1183816790,22-05-2024,19.9,-1.99,644992.0,BOX,Issue to Patient,0.1,12.54252,-1.25425,4.9023,61.48718
6560020099,VOLTAREN 50 MG SUP 10'S,Medicine,Rayan Hospital,RYN_IP,,,,1183816805,22-05-2024,19.9,-3.98,644992.0,BOX,Issue to Patient,0.2,12.54252,-2.5085,4.7023,58.97867
6560020099,VOLTAREN 50 MG SUP 10'S,Medicine,Rayan Hospital,RYN_IP,,,,1183901919,22-05-2024,19.9,-3.98,644992.0,BOX,Issue to Patient,0.2,12.54252,-2.5085,4.5023,56.47017
6560020099,VOLTAREN 50 MG SUP 10'S,Medicine,Rayan Hospital,RYN_IP,,,,1184437440,23-05-2024,19.9,-5.97,644992.0,BOX,Issue to Patient,0.2999,12.54252,-3.7615,4.2024,52.70867
6560020099,VOLTAREN 50 MG SUP 10'S,Medicine,Rayan Hospital,RYN_IP,,,,1185274409,25-05-2024,19.9,-1.99,644992.0,BOX,Issue to Patient,0.1,12.54252,-1.25425,14.1024,176.87958
6560020099,VOLTAREN 50 MG SUP 10'S,Medicine,Rayan Hospital,RYN_IP,,,,1185471829,25-05-2024,19.9,-3.98,644992.0,BOX,Issue to Patient,0.2,12.54252,-2.5085,14.0024,175.62533
6560020099,VOLTAREN 50 MG SUP 10'S,Medicine,Rayan Hospital,RYN_IP,,,,1185517700,25-05-2024,19.9,-3.98,644992.0,BOX,Issue to Patient,0.2,12.54252,-2.5085,13.8024,173.11683
6560020099,VOLTAREN 50 MG SUP 10'S,Medicine,Rayan Hospital,RYN_IP,,,,1185824785,26-05-2024,19.9,-1.99,644992.0,BOX,Issue to Patient,0.1,12.54252,-1.25425,13.7024,171.86258
6560020099,VOLTAREN 50 MG SUP 10'S,Medicine,Rayan Hospital,RYN_IP,,,,1185827309,26-05-2024,19.9,-1.99,644992.0,BOX,Issue to Patient,0.1,12.54252,-1.25425,13.6024,170.60832
6560020099,VOLTAREN 50 MG SUP 10'S,Medicine,Rayan Hospital,RYN_IP,,,,1185829365,26-05-2024,19.9,-3.98,644992.0,BOX,Issue to Patient,0.2,12.54252,-2.5085,13.4024,168.09982
6560020099,VOLTAREN 50 MG SUP 10'S,Medicine,Rayan Hospital,RYN_IP,,,,1185829370,26-05-2024,19.9,-3.98,644992.0,BOX,Issue to Patient,0.2,12.54252,-2.5085,13.2024,165.59132
6560020099,VOLTAREN 50 MG SUP 10'S,Medicine,Rayan Hospital,RYN_IP,,,,1186445334,27-05-2024,19.9,-1.99,644992.0,BOX,Issue to Patient,0.1,12.54252,-1.25425,13.2024,165.59132
6560020099,VOLTAREN 50 MG SUP 10'S,Medicine,Rayan Hospital,RYN_IP,,,,1186466602,27-05-2024,19.9,-1.99,644992.0,BOX,Issue to Patient,0.1,12.54252,-1.25425,13.1024,164.33707
6560020099,VOLTAREN 50 MG SUP 10'S,Medicine,Rayan Hospital,RYN_IP,,,,1186480576,27-05-2024,19.9,-3.98,644992.0,BOX,Issue to Patient,0.2,12.54252,-2.5085,12.9024,161.82856
6560020099,VOLTAREN 50 MG SUP 10'S,Medicine,Rayan Hospital,RYN_IP,,,,1186483480,27-05-2024,19.9,-3.98,644992.0,BOX,Issue to Patient,0.2,12.54252,-2.5085,12.7024,159.32006
6560020099,VOLTAREN 50 MG SUP 10'S,Medicine,Rayan Hospital,RYN_IP,,,,1187741281,29-05-2024,19.9,-1.99,644992.0,BOX,Issue to Patient,0.1,12.54252,-1.25425,12.8024,160.57431
6560020099,VOLTAREN 50 MG SUP 10'S,Medicine,Rayan Hospital,RYN_IP,,,,1187761309,29-05-2024,19.9,-3.98,644992.0,BOX,Issue to Patient,0.2,12.54252,-2.5085,12.6024,158.06581
6560020099,VOLTAREN 50 MG SUP 10'S,Medicine,Rayan Hospital,RYN_IP,,,,1187764423,29-05-2024,19.9,-1.99,644992.0,BOX,Issue to Patient,0.1,12.54252,-1.25425,12.5024,156.81156
6560020099,VOLTAREN 50 MG SUP 10'S,Medicine,Rayan Hospital,RYN_IP,,,,1187779554,29-05-2024,19.9,-3.98,644992.0,BOX,Issue to Patient,0.2,12.54252,-2.5085,12.3024,154.30305
6560020099,VOLTAREN 50 MG SUP 10'S,Medicine,Rayan Hospital,RYN_IP,,,,1188374581,30-05-2024,19.9,-1.99,644992.0,BOX,Issue to Patient,0.1,12.54252,-1.25425,12.2024,153.0488
6560020099,VOLTAREN 50 MG SUP 10'S,Medicine,Rayan Hospital,RYN_IP,,,,1188424554,30-05-2024,19.9,-3.98,644992.0,BOX,Issue to Patient,0.2,12.54252,-2.5085,12.0024,150.5403
6560020099,VOLTAREN 50 MG SUP 10'S,Medicine,Rayan Hospital,RYN_IP,,,,1188424569,30-05-2024,19.9,-3.98,644992.0,BOX,Issue to Patient,0.2,12.54252,-2.5085,11.8024,148.03179
6560020099,VOLTAREN 50 MG SUP 10'S,Medicine,Rayan Hospital,RYN_IP,,,,1188525015,30-05-2024,19.9,-3.98,644992.0,BOX,Issue to Patient,0.2,12.54252,-2.5085,11.9024,149.28605
6560020099,VOLTAREN 50 MG SUP 10'S,Medicine,Rayan Hospital,RYN_IP,,,,1189907190,02-06-2024,19.9,-1.99,644992.0,BOX,Issue to Patient,0.1,12.54252,-1.25425,11.8024,148.03179
6560020099,VOLTAREN 50 MG SUP 10'S,Medicine,Rayan Hospital,RYN_IP,,,,1189938913,02-06-2024,19.9,-1.99,644992.0,BOX,Issue to Patient,0.1,12.54252,-1.25425,11.7024,146.77754
6560020099,VOLTAREN 50 MG SUP 10'S,Medicine,Rayan Hospital,RYN_IP,,,,1190027064,02-06-2024,19.9,-3.98,644992.0,BOX,Issue to Patient,0.2,12.54252,-2.5085,11.5024,144.26904
6560020099,VOLTAREN 50 MG SUP 10'S,Medicine,Rayan Hospital,RYN_IP,,,,1190027079,02-06-2024,19.9,-3.98,644992.0,BOX,Issue to Patient,0.2,12.54252,-2.5085,11.3024,141.76054
6560020099,VOLTAREN 50 MG SUP 10'S,Medicine,Rayan Hospital,RYN_IP,,,,1191884778,05-06-2024,19.9,-1.99,644992.0,BOX,Issue to Patient,0.1,12.54252,-1.25425,11.4024,143.01479
6560020099,VOLTAREN 50 MG SUP 10'S,Medicine,Rayan Hospital,RYN_IP,,,,1191913736,05-06-2024,19.9,-1.99,644992.0,BOX,Issue to Patient,0.1,12.54252,-1.25425,11.3024,141.76054
6560020099,VOLTAREN 50 MG SUP 10'S,Medicine,Rayan Hospital,RYN_IP,,,,1191932746,05-06-2024,19.9,-3.98,644992.0,BOX,Issue to Patient,0.2,12.54252,-2.5085,11.1024,139.25203
6560020099,VOLTAREN 50 MG SUP 10'S,Medicine,Rayan Hospital,RYN_IP,,,,1191944452,05-06-2024,19.9,-3.98,644992.0,BOX,Issue to Patient,0.2,12.54252,-2.5085,10.9024,136.74353
6560020099,VOLTAREN 50 MG SUP 10'S,Medicine,Rayan Hospital,RYN_IP,,,,1192530321,06-06-2024,19.9,-1.99,644992.0,BOX,Issue to Patient,0.1,12.54252,-1.25425,10.8024,135.48928
6560020099,VOLTAREN 50 MG SUP 10'S,Medicine,Rayan Hospital,RYN_IP,,,,1192566423,06-06-2024,19.9,-3.98,644992.0,BOX,Issue to Patient,0.2,12.54252,-2.5085,10.6024,132.98077
6560020099,VOLTAREN 50 MG SUP 10'S,Medicine,Rayan Hospital,RYN_IP,,,,1192589106,06-06-2024,19.9,-5.97,644992.0,BOX,Issue to Patient,0.2999,12.54252,-3.7615,10.3025,129.21927
6560020099,VOLTAREN 50 MG SUP 10'S,Medicine,Rayan Hospital,RYN_IP,Shamal Al Riyadh Co.,,RAY29118,1192893029,06-06-2024,19.9,-39.8,644992.0,BOX,Intransit Shipment,2.0,12.54252,-25.08503,8.3025,104.13424
6560020099,VOLTAREN 50 MG SUP 10'S,Medicine,Rayan Hospital,RYN_IP,,,,1194703439,10-06-2024,19.9,-1.99,644992.0,BOX,Issue to Patient,0.1,12.54252,-1.25425,8.4025,105.38849
6560020099,VOLTAREN 50 MG SUP 10'S,Medicine,Rayan Hospital,RYN_IP,,,,1194783028,10-06-2024,19.9,-3.98,644992.0,BOX,Issue to Patient,0.2,12.54252,-2.5085,8.2025,102.87999
6560020099,VOLTAREN 50 MG SUP 10'S,Medicine,Rayan Hospital,RYN_IP,,,,1194799172,10-06-2024,19.9,-5.97,644992.0,BOX,Issue to Patient,0.2999,12.54252,-3.7615,7.9026,99.11849
6560020099,VOLTAREN 50 MG SUP 10'S,Medicine,Rayan Hospital,RYN_IP,,,,1194801699,10-06-2024,19.9,-5.97,644992.0,BOX,Issue to Patient,0.2999,12.54252,-3.7615,7.6027,95.35699
6560020099,VOLTAREN 50 MG SUP 10'S,Medicine,Rayan Hospital,RYN_IP,,,,1195359130,11-06-2024,19.9,-1.99,644992.0,BOX,Issue to Patient,0.1,12.54252,-1.25425,8.0027,100.374
6560020099,VOLTAREN 50 MG SUP 10'S,Medicine,Rayan Hospital,RYN_IP,,,,1195388235,11-06-2024,19.9,-3.98,644992.0,BOX,Issue to Patient,0.2,12.54252,-2.5085,7.8027,97.86549
6560020099,VOLTAREN 50 MG SUP 10'S,Medicine,Rayan Hospital,RYN_IP,,,,1196049662,12-06-2024,19.9,-1.99,644992.0,BOX,Issue to Patient,0.1,12.54252,-1.25425,7.7027,96.61124
6560020099,VOLTAREN 50 MG SUP 10'S,Medicine,Rayan Hospital,RYN_IP,,,,1196065834,12-06-2024,19.9,-1.99,644992.0,BOX,Issue to Patient,0.1,12.54252,-1.25425,7.6027,95.35699
6560020099,VOLTAREN 50 MG SUP 10'S,Medicine,Rayan Hospital,RYN_IP,,,,1196071771,12-06-2024,19.9,-3.98,644992.0,BOX,Issue to Patient,0.2,12.54252,-2.5085,7.4027,92.84849
6560020099,VOLTAREN 50 MG SUP 10'S,Medicine,Rayan Hospital,RYN_IP,,,,1196071796,12-06-2024,19.9,-3.98,644992.0,BOX,Issue to Patient,0.2,12.54252,-2.5085,7.2027,90.33998
6560020099,VOLTAREN 50 MG SUP 10'S,Medicine,Rayan Hospital,RYN_IP,,,,1196122662,12-06-2024,19.9,-5.97,644992.0,BOX,Issue to Patient,0.2999,12.54252,-3.7615,6.9028,86.57848
6560020099,VOLTAREN 50 MG SUP 10'S,Medicine,Rayan Hospital,RYN_IP,,,,1196920394,13-06-2024,19.9,-3.98,644992.0,BOX,Issue to Patient,0.2,12.54252,-2.5085,7.0028,87.83273
6560020099,VOLTAREN 50 MG SUP 10'S,Medicine,Rayan Hospital,RYN_IP,,,,1197541030,15-06-2024,19.9,-1.99,644992.0,BOX,Issue to Patient,0.1,12.54252,-1.25425,7.1028,89.08698
6560020099,VOLTAREN 50 MG SUP 10'S,Medicine,Rayan Hospital,RYN_IP,,,,1198679458,20-06-2024,19.9,-1.99,644992.0,BOX,Issue to Patient,0.1,12.54252,-1.25425,7.0028,87.83273
6560020099,VOLTAREN 50 MG SUP 10'S,Medicine,Rayan Hospital,RYN_IP,,,,1198697088,20-06-2024,19.9,-1.99,644992.0,BOX,Issue to Patient,0.1,12.54252,-1.25425,6.9028,86.57848
6560020099,VOLTAREN 50 MG SUP 10'S,Medicine,Rayan Hospital,RYN_IP,,,,1198708987,20-06-2024,19.9,-3.98,644992.0,BOX,Issue to Patient,0.2,12.54252,-2.5085,6.7028,84.06998
6560020099,VOLTAREN 50 MG SUP 10'S,Medicine,Rayan Hospital,RYN_IP,,,,1198708997,20-06-2024,19.9,-3.98,644992.0,BOX,Issue to Patient,0.2,12.54252,-2.5085,6.5028,81.56147
6560020099,VOLTAREN 50 MG SUP 10'S,Medicine,Rayan Hospital,RYN_IP,,,,1198742826,20-06-2024,19.9,-3.98,644992.0,BOX,Issue to Patient,0.2,12.54252,-2.5085,6.3028,79.05297
6560020099,VOLTAREN 50 MG SUP 10'S,Medicine,Rayan Hospital,RYN_IP,,,,1200021779,23-06-2024,19.9,-1.99,644992.0,BOX,Issue to Patient,0.1,12.54252,-1.25425,6.3028,79.05297
6560020099,VOLTAREN 50 MG SUP 10'S,Medicine,Rayan Hospital,RYN_IP,,,,1200056070,23-06-2024,19.9,-1.99,644992.0,BOX,Issue to Patient,0.1,12.54252,-1.25425,6.2028,77.79872
6560020099,VOLTAREN 50 MG SUP 10'S,Medicine,Rayan Hospital,RYN_IP,,,,1200075931,23-06-2024,19.9,-3.98,644992.0,BOX,Issue to Patient,0.2,12.54252,-2.5085,6.0028,75.29022
6560020099,VOLTAREN 50 MG SUP 10'S,Medicine,Rayan Hospital,RYN_IP,,,,1200099703,23-06-2024,19.9,-5.97,644992.0,BOX,Issue to Patient,0.2999,12.54252,-3.7615,5.7029,71.52872
6560020099,VOLTAREN 50 MG SUP 10'S,Medicine,Rayan Hospital,RYN_IP,,,,1200109960,23-06-2024,19.9,-3.98,644992.0,BOX,Issue to Patient,0.2,12.54252,-2.5085,5.5029,69.02021
6560020099,VOLTAREN 50 MG SUP 10'S,Medicine,Rayan Hospital,RYN_IP,,,,1200610100,24-06-2024,19.9,-1.99,644992.0,BOX,Issue to Patient,0.1,12.54252,-1.25425,5.4029,67.76596
6560020099,VOLTAREN 50 MG SUP 10'S,Medicine,Rayan Hospital,RYN_IP,,,,1200646477,24-06-2024,19.9,-1.99,644992.0,BOX,Issue to Patient,0.1,12.54252,-1.25425,5.3029,66.51171
6560020099,VOLTAREN 50 MG SUP 10'S,Medicine,Rayan Hospital,RYN_IP,,,,1200730514,24-06-2024,19.9,-3.98,644992.0,BOX,Issue to Patient,0.2,12.54252,-2.5085,5.3029,66.51171
6560020099,VOLTAREN 50 MG SUP 10'S,Medicine,Rayan Hospital,RYN_IP,,,,1200734964,24-06-2024,19.9,-3.98,644992.0,BOX,Issue to Patient,0.2,12.54252,-2.5085,5.1029,64.00321
6560020099,VOLTAREN 50 MG SUP 10'S,Medicine,Rayan Hospital,RYN_IP,,,,1201396655,25-06-2024,19.9,-5.97,644992.0,BOX,Issue to Patient,0.2999,12.54252,-3.7615,8.003,100.37776
6560020099,VOLTAREN 50 MG SUP 10'S,Medicine,Rayan Hospital,RYN_IP,,,,1201812723,26-06-2024,19.9,-1.99,644992.0,BOX,Issue to Patient,0.1,12.54252,-1.25425,8.003,100.37776
6560020099,VOLTAREN 50 MG SUP 10'S,Medicine,Rayan Hospital,RYN_IP,,,,1201823290,26-06-2024,19.9,-3.98,644992.0,BOX,Issue to Patient,0.2,12.54252,-2.5085,7.803,97.86925
6560020099,VOLTAREN 50 MG SUP 10'S,Medicine,Rayan Hospital,RYN_IP,,,,1201823295,26-06-2024,19.9,-3.98,644992.0,BOX,Issue to Patient,0.2,12.54252,-2.5085,7.603,95.36075
6560020099,VOLTAREN 50 MG SUP 10'S,Medicine,Rayan Hospital,RYN_IP,,,,1202379719,27-06-2024,19.9,-1.99,644992.0,BOX,Issue to Patient,0.1,12.54252,-1.25425,7.703,96.615
6560020099,VOLTAREN 50 MG SUP 10'S,Medicine,Rayan Hospital,RYN_IP,,,,1202417648,27-06-2024,19.9,-3.98,644992.0,BOX,Issue to Patient,0.2,12.54252,-2.5085,7.503,94.1065
6560020099,VOLTAREN 50 MG SUP 10'S,Medicine,Rayan Hospital,RYN_IP,,,,1203178497,29-06-2024,19.9,-3.98,644992.0,BOX,Issue to Patient,0.2,12.54252,-2.5085,7.303,91.598
6560020099,VOLTAREN 50 MG SUP 10'S,Medicine,Rayan Hospital,RYN_IP,,,,1203239810,29-06-2024,19.9,-5.97,644992.0,BOX,Issue to Patient,0.2999,12.54252,-3.7615,7.0031,87.8365
6560020099,VOLTAREN 50 MG SUP 10'S,Medicine,Rayan Hospital,RYN_IP,,,,1203707375,30-06-2024,19.9,-1.99,644995.0,BOX,Issue to Patient,0.1,12.54252,-1.25425,7.9031,99.12476
6560020099,VOLTAREN 50 MG SUP 10'S,Medicine,Rayan Hospital,RYN_IP,,,,1203712639,30-06-2024,19.9,-3.98,644992.0,BOX,Issue to Patient,0.2,12.54252,-2.5085,7.7031,96.61626
6560020099,VOLTAREN 50 MG SUP 10'S,Medicine,Rayan Hospital,RYN_IP,,,,1203732282,30-06-2024,19.9,-1.99,644995.0,BOX,Issue to Patient,0.1,12.54252,-1.25425,7.6031,95.36201
6560020099,VOLTAREN 50 MG SUP 10'S,Medicine,Rayan Hospital,RYN_IP,,,,1203811541,30-06-2024,19.9,-5.97,644995.0,BOX,Issue to Patient,0.2999,12.54252,-3.7615,7.3032,91.6005
6560020099,VOLTAREN 50 MG SUP 10'S,Medicine,Rayan Hospital,RYN_IP,,,,1203865401,30-06-2024,19.9,-3.98,644992.0,BOX,Issue to Patient,0.2,12.54252,-2.5085,7.1032,89.092
6560020099,VOLTAREN 50 MG SUP 10'S,Medicine,Rayan Hospital,RYN_IP,,,,1203875826,30-06-2024,19.9,-5.97,644995.0,BOX,Issue to Patient,0.2999,12.54252,-3.7615,6.8033,85.3305
6560020099,VOLTAREN 50 MG SUP 10'S,Medicine,Rayan Hospital,RYN_IP,,,,1203924172,30-06-2024,19.9,-5.97,644992.0,BOX,Issue to Patient,0.2999,12.54252,-3.7615,6.5034,81.569
