Item Code,Description,Item Category,Oraganization,Sub Inventory,To Location,To Subinventory,Document Number,Transaction ID,Transaction DATE,SellingÂ  Price,Value of Selling Price,Lot Number,UOM,Transaction Type,Transaction Quantity,Transaction Cost,Transaction Value,Balance Quantity,Balance Value
6590020029,MAGNESIUM SULPHATE 50% INJ -5ML,Medicine,Rayan Hospital,RYN_IP,,,,1110861204,01-01-2024,2.1,-2.1,8546100.0,PCS,Issue to Patient,1.0,1.58003,-1.58003,2701.0,4267.66567
6590020029,MAGNESIUM SULPHATE 50% INJ -5ML,Medicine,Rayan Hospital,RYN_IP,,,,1110879095,01-01-2024,2.1,-2.1,8546100.0,PCS,Issue to Patient,1.0,1.58003,-1.58003,2700.0,4266.08564
6590020029,MAGNESIUM SULPHATE 50% INJ -5ML,Medicine,Rayan Hospital,RYN_IP,,,,1110936442,01-01-2024,2.1,-2.1,8546103.0,PCS,Issue to Patient,1.0,1.58003,-1.58003,2699.0,4264.50561
6590020029,MAGNESIUM SULPHATE 50% INJ -5ML,Medicine,Rayan Hospital,RYN_IP,,,,1110955062,01-01-2024,2.1,-4.2,8546103.0,PCS,Issue to Patient,2.0,1.58003,-3.16006,2697.0,4261.34555
6590020029,MAGNESIUM SULPHATE 50% INJ -5ML,Medicine,Rayan Hospital,RYN_IP,,,,1111043293,01-01-2024,2.1,-8.4,8546103.0,PCS,Issue to Patient,4.0,1.58003,-6.32013,2693.0,4255.02542
6590020029,MAGNESIUM SULPHATE 50% INJ -5ML,Medicine,Rayan Hospital,RYN_IP,,,,1111096288,01-01-2024,2.1,-2.1,8546100.0,PCS,Issue to Patient,1.0,1.58003,-1.58003,2692.0,4253.44539
6590020029,MAGNESIUM SULPHATE 50% INJ -5ML,Medicine,Rayan Hospital,RYN_IP,,,,1111294365,01-01-2024,2.1,-2.1,8546103.0,PCS,Issue to Patient,1.0,1.58003,-1.58003,2691.0,4251.86536
6590020029,MAGNESIUM SULPHATE 50% INJ -5ML,Medicine,Rayan Hospital,RYN_IP,,,,1111358350,02-01-2024,2.1,-8.4,8546100.0,PCS,Issue to Patient,4.0,1.58003,-6.32013,2687.0,4245.54523
6590020029,MAGNESIUM SULPHATE 50% INJ -5ML,Medicine,Rayan Hospital,RYN_IP,,,,1111373684,02-01-2024,2.1,-4.2,8546103.0,PCS,Issue to Patient,2.0,1.58003,-3.16006,2685.0,4242.38517
6590020029,MAGNESIUM SULPHATE 50% INJ -5ML,Medicine,Rayan Hospital,RYN_IP,,,,1111374408,02-01-2024,2.1,-4.2,8546103.0,PCS,Issue to Patient,2.0,1.58003,-3.16006,2683.0,4239.2251
6590020029,MAGNESIUM SULPHATE 50% INJ -5ML,Medicine,Rayan Hospital,RYN_IP,,,,1111457459,02-01-2024,2.1,-4.2,8546103.0,PCS,Issue to Patient,2.0,1.58003,-3.16006,2681.0,4236.06504
6590020029,MAGNESIUM SULPHATE 50% INJ -5ML,Medicine,Rayan Hospital,RYN_IP,,,,1111521808,02-01-2024,2.1,-6.3,8546103.0,PCS,Issue to Patient,3.0,1.58003,-4.7401,2678.0,4231.32494
6590020029,MAGNESIUM SULPHATE 50% INJ -5ML,Medicine,Rayan Hospital,RYN_IP,,,,1111693177,02-01-2024,2.1,-2.1,8546100.0,PCS,Issue to Patient,1.0,1.58003,-1.58003,2680.0,4234.48501
6590020029,MAGNESIUM SULPHATE 50% INJ -5ML,Medicine,Rayan Hospital,RYN_IP,,,,1111698738,02-01-2024,2.1,-2.1,8546103.0,PCS,Issue to Patient,1.0,1.58003,-1.58003,2679.0,4232.90498
6590020029,MAGNESIUM SULPHATE 50% INJ -5ML,Medicine,Rayan Hospital,RYN_IP,,,,1111708256,02-01-2024,2.1,-4.2,8546103.0,PCS,Issue to Patient,2.0,1.58003,-3.16006,2677.0,4229.74491
6590020029,MAGNESIUM SULPHATE 50% INJ -5ML,Medicine,Rayan Hospital,RYN_IP,,,,1111711671,02-01-2024,2.1,-2.1,8546103.0,PCS,Issue to Patient,1.0,1.58003,-1.58003,2676.0,4228.16488
6590020029,MAGNESIUM SULPHATE 50% INJ -5ML,Medicine,Rayan Hospital,RYN_IP,,,,1111745346,02-01-2024,2.1,-8.4,8546103.0,PCS,Issue to Patient,4.0,1.58003,-6.32013,2672.0,4221.84475
6590020029,MAGNESIUM SULPHATE 50% INJ -5ML,Medicine,Rayan Hospital,RYN_IP,,,,1111829083,02-01-2024,2.1,-2.1,8546103.0,PCS,Issue to Patient,1.0,1.58003,-1.58003,2671.0,4220.26472
6590020029,MAGNESIUM SULPHATE 50% INJ -5ML,Medicine,Rayan Hospital,RYN_IP,,,,1111842944,02-01-2024,2.1,-4.2,8546103.0,PCS,Issue to Patient,2.0,1.58003,-3.16006,2669.0,4217.10466
6590020029,MAGNESIUM SULPHATE 50% INJ -5ML,Medicine,Rayan Hospital,RYN_IP,,,,1111910081,03-01-2024,2.1,-8.4,8546103.0,PCS,Issue to Patient,4.0,1.58003,-6.32013,2665.0,4210.78453
6590020029,MAGNESIUM SULPHATE 50% INJ -5ML,Medicine,Rayan Hospital,RYN_IP,,,,1111940446,03-01-2024,2.1,-2.1,8546100.0,PCS,Issue to Patient,1.0,1.58003,-1.58003,2664.0,4209.2045
6590020029,MAGNESIUM SULPHATE 50% INJ -5ML,Medicine,Rayan Hospital,RYN_IP,,,,1112036975,03-01-2024,2.1,-4.2,8546103.0,PCS,Issue to Patient,2.0,1.58003,-3.16006,2662.0,4206.04444
6590020029,MAGNESIUM SULPHATE 50% INJ -5ML,Medicine,Rayan Hospital,STAGE,Rayan Hospital Clinics,RAY_ER,17444801,1112052858,03-01-2024,2.1,-10.5,854698.0,PCS,Int Order Direct Ship,5.0,1.58003,-7.90016,2657.0,4198.14428
6590020029,MAGNESIUM SULPHATE 50% INJ -5ML,Medicine,Rayan Hospital,RYN_IP,,,,1112127622,03-01-2024,2.1,-8.4,8546103.0,PCS,Issue to Patient,4.0,1.58003,-6.32013,2653.0,4191.82415
6590020029,MAGNESIUM SULPHATE 50% INJ -5ML,Medicine,Rayan Hospital,RYN_IP,,,,1112143249,03-01-2024,2.1,-2.1,8546100.0,PCS,Issue to Patient,1.0,1.58003,-1.58003,2652.0,4190.24412
6590020029,MAGNESIUM SULPHATE 50% INJ -5ML,Medicine,Rayan Hospital,RYN_IP,,,,1112143264,03-01-2024,2.1,-2.1,8546100.0,PCS,Issue to Patient,1.0,1.58003,-1.58003,2651.0,4188.66409
6590020029,MAGNESIUM SULPHATE 50% INJ -5ML,Medicine,Rayan Hospital,RYN_IP,,,,1112144789,03-01-2024,2.1,-2.1,8546100.0,PCS,Issue to Patient,1.0,1.58003,-1.58003,2650.0,4187.08406
6590020029,MAGNESIUM SULPHATE 50% INJ -5ML,Medicine,Rayan Hospital,RYN_IP,,,,1112146890,03-01-2024,2.1,-2.1,8546100.0,PCS,Issue to Patient,1.0,1.58003,-1.58003,2649.0,4185.50402
6590020029,MAGNESIUM SULPHATE 50% INJ -5ML,Medicine,Rayan Hospital,RYN_IP,,,,1112150361,03-01-2024,2.1,-2.1,8546100.0,PCS,Issue to Patient,1.0,1.58003,-1.58003,2648.0,4183.92399
6590020029,MAGNESIUM SULPHATE 50% INJ -5ML,Medicine,Rayan Hospital,RYN_IP,,,,1112153924,03-01-2024,2.1,-2.1,8546100.0,PCS,Issue to Patient,1.0,1.58003,-1.58003,2647.0,4182.34396
6590020029,MAGNESIUM SULPHATE 50% INJ -5ML,Medicine,Rayan Hospital,RYN_IP,,,,1112231813,03-01-2024,2.1,-2.1,8546103.0,PCS,Issue to Patient,1.0,1.58003,-1.58003,2646.0,4180.76393
6590020029,MAGNESIUM SULPHATE 50% INJ -5ML,Medicine,Rayan Hospital,RYN_IP,,,,1112282790,03-01-2024,2.1,-4.2,8546103.0,PCS,Issue to Patient,2.0,1.58003,-3.16006,2644.0,4177.60387
6590020029,MAGNESIUM SULPHATE 50% INJ -5ML,Medicine,Rayan Hospital,RYN_IP,,,,1112320786,03-01-2024,2.1,-8.4,8546103.0,PCS,Issue to Patient,4.0,1.58003,-6.32013,2640.0,4171.28374
6590020029,MAGNESIUM SULPHATE 50% INJ -5ML,Medicine,Rayan Hospital,RYN_IP,,,,1112349172,03-01-2024,2.1,-2.1,8546103.0,PCS,Issue to Patient,1.0,1.58003,-1.58003,2639.0,4169.70371
6590020029,MAGNESIUM SULPHATE 50% INJ -5ML,Medicine,Rayan Hospital,RYN_IP,,,,1112439768,03-01-2024,2.1,-2.1,8546103.0,PCS,Issue to Patient,1.0,1.58003,-1.58003,2638.0,4168.12368
6590020029,MAGNESIUM SULPHATE 50% INJ -5ML,Medicine,Rayan Hospital,RYN_IP,,,,1112483881,04-01-2024,2.1,-8.4,8546103.0,PCS,Issue to Patient,4.0,1.58003,-6.32013,2634.0,4161.80355
6590020029,MAGNESIUM SULPHATE 50% INJ -5ML,Medicine,Rayan Hospital,RYN_IP,,,,1112510291,04-01-2024,2.1,-2.1,8546103.0,PCS,Issue to Patient,1.0,1.58003,-1.58003,2633.0,4160.22352
6590020029,MAGNESIUM SULPHATE 50% INJ -5ML,Medicine,Rayan Hospital,RYN_IP,,,,1112563739,04-01-2024,2.1,-2.1,8546103.0,PCS,Issue to Patient,1.0,1.58003,-1.58003,2632.0,4158.64349
6590020029,MAGNESIUM SULPHATE 50% INJ -5ML,Medicine,Rayan Hospital,RYN_IP,,,,1112628628,04-01-2024,2.1,-2.1,8546103.0,PCS,Issue to Patient,1.0,1.58003,-1.58003,2631.0,4157.06345
6590020029,MAGNESIUM SULPHATE 50% INJ -5ML,Medicine,Rayan Hospital,RYN_IP,,,,1112628866,04-01-2024,2.1,-2.1,8546103.0,PCS,Issue to Patient,1.0,1.58003,-1.58003,2630.0,4155.48342
6590020029,MAGNESIUM SULPHATE 50% INJ -5ML,Medicine,Rayan Hospital,RYN_IP,,,,1112636916,04-01-2024,2.1,-4.2,8546103.0,PCS,Issue to Patient,2.0,1.58003,-3.16006,2628.0,4152.32336
6590020029,MAGNESIUM SULPHATE 50% INJ -5ML,Medicine,Rayan Hospital,RYN_IP,,,,1112654219,04-01-2024,2.1,-4.2,8546103.0,PCS,Issue to Patient,2.0,1.58003,-3.16006,2626.0,4149.1633
6590020029,MAGNESIUM SULPHATE 50% INJ -5ML,Medicine,Rayan Hospital,RYN_IP,,,,1112683956,04-01-2024,2.1,-2.1,8546103.0,PCS,Issue to Patient,1.0,1.58003,-1.58003,2625.0,4147.58326
6590020029,MAGNESIUM SULPHATE 50% INJ -5ML,Medicine,Rayan Hospital,RYN_IP,,,,1112724814,04-01-2024,2.1,-6.3,8546103.0,PCS,Issue to Patient,3.0,1.58003,-4.7401,2622.0,4142.84317
6590020029,MAGNESIUM SULPHATE 50% INJ -5ML,Medicine,Rayan Hospital,RYN_IP,,,,1112758441,04-01-2024,2.1,-2.1,8546100.0,PCS,Issue to Patient,1.0,1.58003,-1.58003,2621.0,4141.26314
6590020029,MAGNESIUM SULPHATE 50% INJ -5ML,Medicine,Rayan Hospital,RYN_IP,,,,1112774420,04-01-2024,2.1,-2.1,8546100.0,PCS,Issue to Patient,1.0,1.58003,-1.58003,2620.0,4139.68311
6590020029,MAGNESIUM SULPHATE 50% INJ -5ML,Medicine,Rayan Hospital,RYN_IP,,,,1112782119,04-01-2024,2.1,-2.1,8546100.0,PCS,Issue to Patient,1.0,1.58003,-1.58003,2619.0,4138.10307
6590020029,MAGNESIUM SULPHATE 50% INJ -5ML,Medicine,Rayan Hospital,RYN_IP,,,,1112788536,04-01-2024,2.1,-2.1,8546103.0,PCS,Issue to Patient,1.0,1.58003,-1.58003,2618.0,4136.52304
6590020029,MAGNESIUM SULPHATE 50% INJ -5ML,Medicine,Rayan Hospital,RYN_IP,,,,1112791135,04-01-2024,2.1,-2.1,8546106.0,PCS,Issue to Patient,1.0,1.58003,-1.58003,2617.0,4134.94301
6590020029,MAGNESIUM SULPHATE 50% INJ -5ML,Medicine,Rayan Hospital,RYN_IP,,,,1112794304,04-01-2024,2.1,-2.1,8546100.0,PCS,Issue to Patient,1.0,1.58003,-1.58003,2616.0,4133.36298
6590020029,MAGNESIUM SULPHATE 50% INJ -5ML,Medicine,Rayan Hospital,RYN_IP,,,,1112801682,04-01-2024,2.1,-2.1,8546100.0,PCS,Issue to Patient,1.0,1.58003,-1.58003,2615.0,4131.78295
6590020029,MAGNESIUM SULPHATE 50% INJ -5ML,Medicine,Rayan Hospital,STAGE,Rayan Hospital Clinics,RAY_ER,17450180,1112805887,04-01-2024,2.1,-4.2,8546100.0,PCS,Int Order Direct Ship,2.0,1.58003,-3.16006,2613.0,4128.62288
6590020029,MAGNESIUM SULPHATE 50% INJ -5ML,Medicine,Rayan Hospital,RYN_IP,,,,1112819050,04-01-2024,2.1,-2.1,8546103.0,PCS,Issue to Patient,1.0,1.58003,-1.58003,2612.0,4127.04285
6590020029,MAGNESIUM SULPHATE 50% INJ -5ML,Medicine,Rayan Hospital,RYN_IP,,,,1113087879,05-01-2024,2.1,-4.2,8546103.0,PCS,Issue to Patient,2.0,1.58003,-3.16006,2610.0,4123.88279
6590020029,MAGNESIUM SULPHATE 50% INJ -5ML,Medicine,Rayan Hospital,RYN_IP,,,,1113113154,05-01-2024,2.1,-4.2,8546103.0,PCS,Issue to Patient,2.0,1.58003,-3.16006,2608.0,4120.72272
6590020029,MAGNESIUM SULPHATE 50% INJ -5ML,Medicine,Rayan Hospital,RYN_IP,,,,1113140525,05-01-2024,2.1,-2.1,8546103.0,PCS,Issue to Patient,1.0,1.58003,-1.58003,2607.0,4119.14269
6590020029,MAGNESIUM SULPHATE 50% INJ -5ML,Medicine,Rayan Hospital,RYN_IP,,,,1113156928,05-01-2024,2.1,-2.1,8546106.0,PCS,Issue to Patient,1.0,1.58003,-1.58003,2606.0,4117.56266
6590020029,MAGNESIUM SULPHATE 50% INJ -5ML,Medicine,Rayan Hospital,RYN_IP,,,,1113158905,05-01-2024,2.1,-2.1,8546106.0,PCS,Issue to Patient,1.0,1.58003,-1.58003,2605.0,4115.98263
6590020029,MAGNESIUM SULPHATE 50% INJ -5ML,Medicine,Rayan Hospital,RYN_IP,,,,1113162802,05-01-2024,2.1,-2.1,8546106.0,PCS,Issue to Patient,1.0,1.58003,-1.58003,2604.0,4114.4026
6590020029,MAGNESIUM SULPHATE 50% INJ -5ML,Medicine,Rayan Hospital,RYN_IP,,,,1113172517,05-01-2024,2.1,-2.1,8546106.0,PCS,Issue to Patient,1.0,1.58003,-1.58003,2603.0,4112.82257
6590020029,MAGNESIUM SULPHATE 50% INJ -5ML,Medicine,Rayan Hospital,RYN_IP,,,,1113173335,05-01-2024,2.1,-2.1,8546106.0,PCS,Issue to Patient,1.0,1.58003,-1.58003,2602.0,4111.24253
6590020029,MAGNESIUM SULPHATE 50% INJ -5ML,Medicine,Rayan Hospital,RYN_IP,,,,1113173759,05-01-2024,2.1,-2.1,8546106.0,PCS,Issue to Patient,1.0,1.58003,-1.58003,2601.0,4109.6625
6590020029,MAGNESIUM SULPHATE 50% INJ -5ML,Medicine,Rayan Hospital,RYN_IP,,,,1113173769,05-01-2024,2.1,-2.1,8546106.0,PCS,Issue to Patient,1.0,1.58003,-1.58003,2600.0,4108.08247
6590020029,MAGNESIUM SULPHATE 50% INJ -5ML,Medicine,Rayan Hospital,RYN_IP,,,,1113260933,05-01-2024,2.1,-2.1,8546103.0,PCS,Issue to Patient,1.0,1.58003,-1.58003,2599.0,4106.50244
6590020029,MAGNESIUM SULPHATE 50% INJ -5ML,Medicine,Rayan Hospital,RYN_IP,,,,1113277035,06-01-2024,2.1,-2.1,8546103.0,PCS,Issue to Patient,1.0,1.58003,-1.58003,2598.0,4104.92241
6590020029,MAGNESIUM SULPHATE 50% INJ -5ML,Medicine,Rayan Hospital,RYN_IP,,,,1113352849,06-01-2024,2.1,-4.2,8546103.0,PCS,Issue to Patient,2.0,1.58003,-3.16006,2596.0,4101.76234
6590020029,MAGNESIUM SULPHATE 50% INJ -5ML,Medicine,Rayan Hospital,RYN_IP,,,,1113354836,06-01-2024,2.1,-2.1,8546103.0,PCS,Issue to Patient,1.0,1.58003,-1.58003,2595.0,4100.18231
6590020029,MAGNESIUM SULPHATE 50% INJ -5ML,Medicine,Rayan Hospital,RYN_IP,,,,1113362389,06-01-2024,2.1,-2.1,8546103.0,PCS,Issue to Patient,1.0,1.58003,-1.58003,2594.0,4098.60228
6590020029,MAGNESIUM SULPHATE 50% INJ -5ML,Medicine,Rayan Hospital,RYN_IP,,,,1113386926,06-01-2024,2.1,-4.2,8546103.0,PCS,Issue to Patient,2.0,1.58003,-3.16006,2592.0,4095.44222
6590020029,MAGNESIUM SULPHATE 50% INJ -5ML,Medicine,Rayan Hospital,RYN_IP,,,,1113392976,06-01-2024,2.1,-4.2,8546103.0,PCS,Issue to Patient,2.0,1.58003,-3.16006,2590.0,4092.28215
6590020029,MAGNESIUM SULPHATE 50% INJ -5ML,Medicine,Rayan Hospital,RYN_IP,,,,1113410456,06-01-2024,2.1,-4.2,8546103.0,PCS,Issue to Patient,2.0,1.58003,-3.16006,2588.0,4089.12209
6590020029,MAGNESIUM SULPHATE 50% INJ -5ML,Medicine,Rayan Hospital,RYN_IP,,,,1113478692,06-01-2024,2.1,-2.1,8546103.0,PCS,Issue to Patient,1.0,1.58003,-1.58003,2587.0,4087.54206
6590020029,MAGNESIUM SULPHATE 50% INJ -5ML,Medicine,Rayan Hospital,RYN_IP,,,,1113520913,06-01-2024,2.1,-2.1,8546100.0,PCS,Issue to Patient,1.0,1.58003,-1.58003,2586.0,4085.96203
6590020029,MAGNESIUM SULPHATE 50% INJ -5ML,Medicine,Rayan Hospital,RYN_IP,,,,1113523049,06-01-2024,2.1,-2.1,8546100.0,PCS,Issue to Patient,1.0,1.58003,-1.58003,2585.0,4084.38199
6590020029,MAGNESIUM SULPHATE 50% INJ -5ML,Medicine,Rayan Hospital,RYN_IP,,,,1113525870,06-01-2024,2.1,-2.1,8546103.0,PCS,Issue to Patient,1.0,1.58003,-1.58003,2584.0,4082.80196
6590020029,MAGNESIUM SULPHATE 50% INJ -5ML,Medicine,Rayan Hospital,RYN_IP,,,,1113545304,06-01-2024,2.1,-2.1,8546106.0,PCS,Issue to Patient,1.0,1.58003,-1.58003,2583.0,4081.22193
6590020029,MAGNESIUM SULPHATE 50% INJ -5ML,Medicine,Rayan Hospital,RYN_IP,,,,1113807296,06-01-2024,2.1,-2.1,8546103.0,PCS,Issue to Patient,1.0,1.58003,-1.58003,2582.0,4079.6419
6590020029,MAGNESIUM SULPHATE 50% INJ -5ML,Medicine,Rayan Hospital,RYN_IP,,,,1113807466,06-01-2024,2.1,-4.2,8546103.0,PCS,Issue to Patient,2.0,1.58003,-3.16006,2580.0,4076.48184
6590020029,MAGNESIUM SULPHATE 50% INJ -5ML,Medicine,Rayan Hospital,RYN_IP,,,,1113954080,07-01-2024,2.1,-4.2,8546103.0,PCS,Issue to Patient,2.0,1.58003,-3.16006,2578.0,4073.32177
6590020029,MAGNESIUM SULPHATE 50% INJ -5ML,Medicine,Rayan Hospital,RYN_IP,,,,1113967387,07-01-2024,2.1,-4.2,8546103.0,PCS,Issue to Patient,2.0,1.58003,-3.16006,2576.0,4070.16171
6590020029,MAGNESIUM SULPHATE 50% INJ -5ML,Medicine,Rayan Hospital,RYN_IP,,,,1113968020,07-01-2024,2.1,-2.1,8546103.0,PCS,Issue to Patient,1.0,1.58003,-1.58003,2575.0,4068.58168
6590020029,MAGNESIUM SULPHATE 50% INJ -5ML,Medicine,Rayan Hospital,RYN_IP,,,,1113971075,07-01-2024,2.1,-2.1,8546103.0,PCS,Issue to Patient,1.0,1.58003,-1.58003,2574.0,4067.00165
6590020029,MAGNESIUM SULPHATE 50% INJ -5ML,Medicine,Rayan Hospital,RYN_IP,,,,1114030461,07-01-2024,2.1,-2.1,8546106.0,PCS,Issue to Patient,1.0,1.58003,-1.58003,2573.0,4065.42161
6590020029,MAGNESIUM SULPHATE 50% INJ -5ML,Medicine,Rayan Hospital,RYN_IP,,,,1114032029,07-01-2024,2.1,-2.1,8546106.0,PCS,Issue to Patient,1.0,1.58003,-1.58003,2572.0,4063.84158
6590020029,MAGNESIUM SULPHATE 50% INJ -5ML,Medicine,Rayan Hospital,RYN_IP,,,,1114035837,07-01-2024,2.1,-2.1,8546106.0,PCS,Issue to Patient,1.0,1.58003,-1.58003,2571.0,4062.26155
6590020029,MAGNESIUM SULPHATE 50% INJ -5ML,Medicine,Rayan Hospital,RYN_IP,,,,1114035914,07-01-2024,2.1,-2.1,8546106.0,PCS,Issue to Patient,1.0,1.58003,-1.58003,2570.0,4060.68152
6590020029,MAGNESIUM SULPHATE 50% INJ -5ML,Medicine,Rayan Hospital,RYN_IP,,,,1114041552,07-01-2024,2.1,-2.1,8546106.0,PCS,Issue to Patient,1.0,1.58003,-1.58003,2569.0,4059.10149
6590020029,MAGNESIUM SULPHATE 50% INJ -5ML,Medicine,Rayan Hospital,RYN_IP,,,,1114041562,07-01-2024,2.1,-2.1,8546103.0,PCS,Issue to Patient,1.0,1.58003,-1.58003,2568.0,4057.52146
6590020029,MAGNESIUM SULPHATE 50% INJ -5ML,Medicine,Rayan Hospital,RYN_IP,,,,1114044430,07-01-2024,2.1,-2.1,8546103.0,PCS,Issue to Patient,1.0,1.58003,-1.58003,2567.0,4055.94142
6590020029,MAGNESIUM SULPHATE 50% INJ -5ML,Medicine,Rayan Hospital,RYN_IP,,,,1114650357,08-01-2024,2.1,-2.1,8546100.0,PCS,Issue to Patient,1.0,1.58003,-1.58003,2566.0,4054.36139
6590020029,MAGNESIUM SULPHATE 50% INJ -5ML,Medicine,Rayan Hospital,RYN_IP,,,,1114653341,08-01-2024,2.1,-2.1,8546100.0,PCS,Issue to Patient,1.0,1.58003,-1.58003,2565.0,4052.78136
6590020029,MAGNESIUM SULPHATE 50% INJ -5ML,Medicine,Rayan Hospital,RYN_IP,,,,1114653416,08-01-2024,2.1,-2.1,8546100.0,PCS,Issue to Patient,1.0,1.58003,-1.58003,2564.0,4051.20133
6590020029,MAGNESIUM SULPHATE 50% INJ -5ML,Medicine,Rayan Hospital,STAGE,Rayan Hospital Clinics,RAY_ER,17451407,1114825258,08-01-2024,2.1,-6.3,8546100.0,PCS,Int Order Direct Ship,3.0,1.58003,-4.7401,2561.0,4046.46123
6590020029,MAGNESIUM SULPHATE 50% INJ -5ML,Medicine,Rayan Hospital,RYN_IP,,,,1114826132,08-01-2024,2.1,-8.4,8546103.0,PCS,Issue to Patient,4.0,1.58003,-6.32013,2557.0,4040.14111
6590020029,MAGNESIUM SULPHATE 50% INJ -5ML,Medicine,Rayan Hospital,RYN_IP,,,,1114875429,08-01-2024,2.1,-2.1,8546103.0,PCS,Issue to Patient,1.0,1.58003,-1.58003,2556.0,4038.56108
6590020029,MAGNESIUM SULPHATE 50% INJ -5ML,Medicine,Rayan Hospital,RYN_IP,,,,1114879130,08-01-2024,2.1,-2.1,8546103.0,PCS,Issue to Patient,1.0,1.58003,-1.58003,2555.0,4036.98104
6590020029,MAGNESIUM SULPHATE 50% INJ -5ML,Medicine,Rayan Hospital,RYN_IP,,,,1115060041,09-01-2024,2.1,-2.1,8546103.0,PCS,Issue to Patient,1.0,1.58003,-1.58003,2554.0,4035.40101
6590020029,MAGNESIUM SULPHATE 50% INJ -5ML,Medicine,Rayan Hospital,RYN_IP,,,,1115177452,09-01-2024,2.1,-4.2,8546103.0,PCS,Issue to Patient,2.0,1.58003,-3.16006,2552.0,4032.24095
6590020029,MAGNESIUM SULPHATE 50% INJ -5ML,Medicine,Rayan Hospital,RYN_IP,,,,1115237987,09-01-2024,2.1,-8.4,8546103.0,PCS,Issue to Patient,4.0,1.58003,-6.32013,2548.0,4025.92082
6590020029,MAGNESIUM SULPHATE 50% INJ -5ML,Medicine,Rayan Hospital,RYN_IP,,,,1115238017,09-01-2024,2.1,-2.1,8546103.0,PCS,Issue to Patient,1.0,1.58003,-1.58003,2547.0,4024.34079
6590020029,MAGNESIUM SULPHATE 50% INJ -5ML,Medicine,Rayan Hospital,RYN_IP,,,,1115277632,09-01-2024,2.1,-2.1,8546103.0,PCS,Issue to Patient,1.0,1.58003,-1.58003,2546.0,4022.76076
6590020029,MAGNESIUM SULPHATE 50% INJ -5ML,Medicine,Rayan Hospital,RYN_IP,,,,1115335796,09-01-2024,2.1,-2.1,8546105.0,PCS,Issue to Patient,1.0,1.58003,-1.58003,2545.0,4021.18073
6590020029,MAGNESIUM SULPHATE 50% INJ -5ML,Medicine,Rayan Hospital,RYN_IP,,,,1115345693,09-01-2024,2.1,-2.1,8546105.0,PCS,Issue to Patient,1.0,1.58003,-1.58003,2544.0,4019.60069
6590020029,MAGNESIUM SULPHATE 50% INJ -5ML,Medicine,Rayan Hospital,RYN_IP,,,,1115349825,09-01-2024,2.1,-2.1,8546100.0,PCS,Issue to Patient,1.0,1.58003,-1.58003,2543.0,4018.02066
6590020029,MAGNESIUM SULPHATE 50% INJ -5ML,Medicine,Rayan Hospital,RYN_IP,,,,1115429508,09-01-2024,2.1,-2.1,8546103.0,PCS,Issue to Patient,1.0,1.58003,-1.58003,2542.0,4016.44063
6590020029,MAGNESIUM SULPHATE 50% INJ -5ML,Medicine,Rayan Hospital,RYN_IP,,,,1115477596,09-01-2024,2.1,-2.1,8546103.0,PCS,Issue to Patient,1.0,1.58003,-1.58003,2541.0,4014.8606
6590020029,MAGNESIUM SULPHATE 50% INJ -5ML,Medicine,Rayan Hospital,RYN_IP,,,,1115503879,09-01-2024,2.1,-2.1,8546103.0,PCS,Issue to Patient,1.0,1.58003,-1.58003,2540.0,4013.28057
6590020029,MAGNESIUM SULPHATE 50% INJ -5ML,Medicine,Rayan Hospital,RYN_IP,,,,1115534468,09-01-2024,2.1,-2.1,8546103.0,PCS,Issue to Patient,1.0,1.58003,-1.58003,2539.0,4011.70054
6590020029,MAGNESIUM SULPHATE 50% INJ -5ML,Medicine,Rayan Hospital,RYN_IP,,,,1115575037,10-01-2024,2.1,-2.1,8546103.0,PCS,Issue to Patient,1.0,1.58003,-1.58003,2538.0,4010.1205
6590020029,MAGNESIUM SULPHATE 50% INJ -5ML,Medicine,Rayan Hospital,RYN_IP,,,,1115595768,10-01-2024,2.1,-4.2,8546103.0,PCS,Issue to Patient,2.0,1.58003,-3.16006,2536.0,4006.96044
6590020029,MAGNESIUM SULPHATE 50% INJ -5ML,Medicine,Rayan Hospital,RYN_IP,,,,1115599983,10-01-2024,2.1,-4.2,8546103.0,PCS,Issue to Patient,2.0,1.58003,-3.16006,2534.0,4003.80038
6590020029,MAGNESIUM SULPHATE 50% INJ -5ML,Medicine,Rayan Hospital,RYN_IP,,,,1115603341,10-01-2024,2.1,-8.4,8546103.0,PCS,Issue to Patient,4.0,1.58003,-6.32013,2530.0,3997.48025
6590020029,MAGNESIUM SULPHATE 50% INJ -5ML,Medicine,Rayan Hospital,RYN_IP,,,,1115604612,10-01-2024,2.1,-6.3,8546103.0,PCS,Issue to Patient,3.0,1.58003,-4.7401,2527.0,3992.74016
6590020029,MAGNESIUM SULPHATE 50% INJ -5ML,Medicine,Rayan Hospital,RYN_IP,,,,1115684587,10-01-2024,2.1,-4.2,8546103.0,PCS,Issue to Patient,2.0,1.58003,-3.16006,2525.0,3989.58009
6590020029,MAGNESIUM SULPHATE 50% INJ -5ML,Medicine,Rayan Hospital,RYN_IP,,,,1115703987,10-01-2024,2.1,-4.2,8546103.0,PCS,Issue to Patient,2.0,1.58003,-3.16006,2523.0,3986.42003
6590020029,MAGNESIUM SULPHATE 50% INJ -5ML,Medicine,Rayan Hospital,RYN_IP,,,,1115703992,10-01-2024,2.1,-4.2,8546103.0,PCS,Issue to Patient,2.0,1.58003,-3.16006,2521.0,3983.25996
6590020029,MAGNESIUM SULPHATE 50% INJ -5ML,Medicine,Rayan Hospital,RYN_IP,,,,1115720546,10-01-2024,2.1,-4.2,8546103.0,PCS,Issue to Patient,2.0,1.58003,-3.16006,2519.0,3980.0999
6590020029,MAGNESIUM SULPHATE 50% INJ -5ML,Medicine,Rayan Hospital,RYN_IP,,,,1115735704,10-01-2024,2.1,-2.1,8546103.0,PCS,Issue to Patient,1.0,1.58003,-1.58003,2518.0,3978.51987
6590020029,MAGNESIUM SULPHATE 50% INJ -5ML,Medicine,Rayan Hospital,RYN_IP,,,,1115746007,10-01-2024,2.1,-2.1,8546103.0,PCS,Issue to Patient,1.0,1.58003,-1.58003,2517.0,3976.93984
6590020029,MAGNESIUM SULPHATE 50% INJ -5ML,Medicine,Rayan Hospital,RYN_IP,,,,1115795641,10-01-2024,2.1,-2.1,8546103.0,PCS,Issue to Patient,1.0,1.58003,-1.58003,2516.0,3975.35981
6590020029,MAGNESIUM SULPHATE 50% INJ -5ML,Medicine,Rayan Hospital,RYN_IP,,,,1115878253,10-01-2024,2.1,-4.2,8546103.0,PCS,Issue to Patient,2.0,1.58003,-3.16006,2514.0,3972.19974
6590020029,MAGNESIUM SULPHATE 50% INJ -5ML,Medicine,Rayan Hospital,RYN_IP,,,,1115937810,10-01-2024,2.1,-2.1,8546105.0,PCS,Issue to Patient,1.0,1.58003,-1.58003,2513.0,3970.61971
6590020029,MAGNESIUM SULPHATE 50% INJ -5ML,Medicine,Rayan Hospital,RYN_IP,,,,1115938221,10-01-2024,2.1,-2.1,8546105.0,PCS,Issue to Patient,1.0,1.58003,-1.58003,2512.0,3969.03968
6590020029,MAGNESIUM SULPHATE 50% INJ -5ML,Medicine,Rayan Hospital,RYN_IP,,,,1115973983,10-01-2024,2.1,-8.4,8546103.0,PCS,Issue to Patient,4.0,1.58003,-6.32013,2508.0,3962.71955
6590020029,MAGNESIUM SULPHATE 50% INJ -5ML,Medicine,Rayan Hospital,RYN_IP,,,,1115985101,10-01-2024,2.1,-2.1,8546104.0,PCS,Issue to Patient,1.0,1.58003,-1.58003,2507.0,3961.13952
6590020029,MAGNESIUM SULPHATE 50% INJ -5ML,Medicine,Rayan Hospital,RYN_IP,,,,1116034897,10-01-2024,2.1,-2.1,8546103.0,PCS,Issue to Patient,1.0,1.58003,-1.58003,2506.0,3959.55949
6590020029,MAGNESIUM SULPHATE 50% INJ -5ML,Medicine,Rayan Hospital,RYN_IP,,,,1116113989,10-01-2024,2.1,-4.2,8546103.0,PCS,Issue to Patient,2.0,1.58003,-3.16006,2504.0,3956.39943
6590020029,MAGNESIUM SULPHATE 50% INJ -5ML,Medicine,Rayan Hospital,RYN_IP,,,,1116149681,11-01-2024,2.1,-4.2,8546103.0,PCS,Issue to Patient,2.0,1.58003,-3.16006,2502.0,3953.23936
6590020029,MAGNESIUM SULPHATE 50% INJ -5ML,Medicine,Rayan Hospital,RYN_IP,,,,1116165536,11-01-2024,2.1,-8.4,8546103.0,PCS,Issue to Patient,4.0,1.58003,-6.32013,2498.0,3946.91924
6590020029,MAGNESIUM SULPHATE 50% INJ -5ML,Medicine,Rayan Hospital,RYN_IP,,,,1116247475,11-01-2024,2.1,-4.2,8546103.0,PCS,Issue to Patient,2.0,1.58003,-3.16006,2496.0,3943.75917
6590020029,MAGNESIUM SULPHATE 50% INJ -5ML,Medicine,Rayan Hospital,RYN_IP,,,,1116282160,11-01-2024,2.1,-4.2,8546103.0,PCS,Issue to Patient,2.0,1.58003,-3.16006,2494.0,3940.59911
6590020029,MAGNESIUM SULPHATE 50% INJ -5ML,Medicine,Rayan Hospital,RYN_IP,,,,1116367852,11-01-2024,2.1,-2.1,8546103.0,PCS,Issue to Patient,1.0,1.58003,-1.58003,2493.0,3939.01908
6590020029,MAGNESIUM SULPHATE 50% INJ -5ML,Medicine,Rayan Hospital,RYN_IP,,,,1116372182,11-01-2024,2.1,-4.2,8546103.0,PCS,Issue to Patient,2.0,1.58003,-3.16006,2491.0,3935.85901
6590020029,MAGNESIUM SULPHATE 50% INJ -5ML,Medicine,Rayan Hospital,RYN_IP,,,,1116375876,11-01-2024,2.1,-2.1,8546103.0,PCS,Issue to Patient,1.0,1.58003,-1.58003,2490.0,3934.27898
6590020029,MAGNESIUM SULPHATE 50% INJ -5ML,Medicine,Rayan Hospital,RYN_IP,,,,1116410612,11-01-2024,2.1,-2.1,8546103.0,PCS,Issue to Patient,1.0,1.58003,-1.58003,2489.0,3932.69895
6590020029,MAGNESIUM SULPHATE 50% INJ -5ML,Medicine,Rayan Hospital,RYN_IP,,,,1116415161,11-01-2024,2.1,-2.1,8546103.0,PCS,Issue to Patient,1.0,1.58003,-1.58003,2488.0,3931.11892
6590020029,MAGNESIUM SULPHATE 50% INJ -5ML,Medicine,Rayan Hospital,RYN_IP,,,,1116416990,11-01-2024,2.1,-2.1,8546103.0,PCS,Issue to Patient,1.0,1.58003,-1.58003,2487.0,3929.53889
6590020029,MAGNESIUM SULPHATE 50% INJ -5ML,Medicine,Rayan Hospital,RYN_IP,,,,1116417005,11-01-2024,2.1,-2.1,8546103.0,PCS,Issue to Patient,1.0,1.58003,-1.58003,2486.0,3927.95885
6590020029,MAGNESIUM SULPHATE 50% INJ -5ML,Medicine,Rayan Hospital,RYN_IP,,,,1116417015,11-01-2024,2.1,-2.1,8546103.0,PCS,Issue to Patient,1.0,1.58003,-1.58003,2485.0,3926.37882
6590020029,MAGNESIUM SULPHATE 50% INJ -5ML,Medicine,Rayan Hospital,RYN_IP,,,,1116491078,11-01-2024,2.1,-4.2,8546103.0,PCS,Issue to Patient,2.0,1.58003,-3.16006,2483.0,3923.21876
6590020029,MAGNESIUM SULPHATE 50% INJ -5ML,Medicine,Rayan Hospital,RYN_IP,,,,1116600021,11-01-2024,2.1,-2.1,8546103.0,PCS,Issue to Patient,1.0,1.58003,-1.58003,2482.0,3921.63873
6590020029,MAGNESIUM SULPHATE 50% INJ -5ML,Medicine,Rayan Hospital,RYN_IP,,,,1116643227,11-01-2024,2.1,-2.1,8546103.0,PCS,Issue to Patient,1.0,1.58003,-1.58003,2481.0,3920.0587
6590020029,MAGNESIUM SULPHATE 50% INJ -5ML,Medicine,Rayan Hospital,RYN_IP,,,,1116658618,12-01-2024,2.1,-2.1,8546103.0,PCS,Issue to Patient,1.0,1.58003,-1.58003,2480.0,3918.47866
6590020029,MAGNESIUM SULPHATE 50% INJ -5ML,Medicine,Rayan Hospital,RYN_IP,,,,1116673219,12-01-2024,2.1,-2.1,8546103.0,PCS,Issue to Patient,1.0,1.58003,-1.58003,2479.0,3916.89863
6590020029,MAGNESIUM SULPHATE 50% INJ -5ML,Medicine,Rayan Hospital,RYN_IP,,,,1116675545,12-01-2024,2.1,-2.1,8546103.0,PCS,Issue to Patient,1.0,1.58003,-1.58003,2478.0,3915.3186
6590020029,MAGNESIUM SULPHATE 50% INJ -5ML,Medicine,Rayan Hospital,RYN_IP,,,,1116702921,12-01-2024,2.1,-2.1,8546103.0,PCS,Issue to Patient,1.0,1.58003,-1.58003,2477.0,3913.73857
6590020029,MAGNESIUM SULPHATE 50% INJ -5ML,Medicine,Rayan Hospital,RYN_IP,,,,1116714839,12-01-2024,2.1,-4.2,8546103.0,PCS,Issue to Patient,2.0,1.58003,-3.16006,2475.0,3910.57851
6590020029,MAGNESIUM SULPHATE 50% INJ -5ML,Medicine,Rayan Hospital,RYN_IP,,,,1116731370,12-01-2024,2.1,-8.4,8546103.0,PCS,Issue to Patient,4.0,1.58003,-6.32013,2471.0,3904.25838
6590020029,MAGNESIUM SULPHATE 50% INJ -5ML,Medicine,Rayan Hospital,RYN_IP,,,,1116748245,12-01-2024,2.1,-4.2,8546103.0,PCS,Issue to Patient,2.0,1.58003,-3.16006,2469.0,3901.09832
6590020029,MAGNESIUM SULPHATE 50% INJ -5ML,Medicine,Rayan Hospital,RYN_IP,,,,1116750706,12-01-2024,2.1,-4.2,8546103.0,PCS,Issue to Patient,2.0,1.58003,-3.16006,2467.0,3897.93825
6590020029,MAGNESIUM SULPHATE 50% INJ -5ML,Medicine,Rayan Hospital,RYN_IP,,,,1116771835,12-01-2024,2.1,-8.4,8546103.0,PCS,Issue to Patient,4.0,1.58003,-6.32013,2463.0,3891.61813
6590020029,MAGNESIUM SULPHATE 50% INJ -5ML,Medicine,Rayan Hospital,RYN_IP,,,,1116776023,12-01-2024,2.1,-4.2,8546106.0,PCS,Issue to Patient,2.0,1.58003,-3.16006,2461.0,3888.45806
6590020029,MAGNESIUM SULPHATE 50% INJ -5ML,Medicine,Rayan Hospital,RYN_IP,,,,1116776486,12-01-2024,2.1,-2.1,8546106.0,PCS,Issue to Patient,1.0,1.58003,-1.58003,2460.0,3886.87803
6590020029,MAGNESIUM SULPHATE 50% INJ -5ML,Medicine,Rayan Hospital,RYN_IP,,,,1116776491,12-01-2024,2.1,-4.2,8546103.0,PCS,Issue to Patient,2.0,1.58003,-3.16006,2458.0,3883.71797
6590020029,MAGNESIUM SULPHATE 50% INJ -5ML,Medicine,Rayan Hospital,RYN_IP,,,,1116892514,12-01-2024,2.1,-2.1,8546103.0,PCS,Issue to Patient,1.0,1.58003,-1.58003,2457.0,3882.13793
6590020029,MAGNESIUM SULPHATE 50% INJ -5ML,Medicine,Rayan Hospital,RYN_IP,,,,1116916038,13-01-2024,2.1,-2.1,8546103.0,PCS,Issue to Patient,1.0,1.58003,-1.58003,2456.0,3880.5579
6590020029,MAGNESIUM SULPHATE 50% INJ -5ML,Medicine,Rayan Hospital,RYN_IP,,,,1116930029,13-01-2024,2.1,-2.1,8546103.0,PCS,Issue to Patient,1.0,1.58003,-1.58003,2455.0,3878.97787
6590020029,MAGNESIUM SULPHATE 50% INJ -5ML,Medicine,Rayan Hospital,RYN_IP,,,,1116946279,13-01-2024,2.1,-4.2,8546104.0,PCS,Issue to Patient,2.0,1.58003,-3.16006,2453.0,3875.81781
6590020029,MAGNESIUM SULPHATE 50% INJ -5ML,Medicine,Rayan Hospital,RYN_IP,,,,1116949359,13-01-2024,2.1,-2.1,8546103.0,PCS,Issue to Patient,1.0,1.58003,-1.58003,2452.0,3874.23778
6590020029,MAGNESIUM SULPHATE 50% INJ -5ML,Medicine,Rayan Hospital,RYN_IP,,,,1116953273,13-01-2024,2.1,-4.2,8546103.0,PCS,Issue to Patient,2.0,1.58003,-3.16006,2450.0,3871.07771
6590020029,MAGNESIUM SULPHATE 50% INJ -5ML,Medicine,Rayan Hospital,RYN_IP,,,,1116992074,13-01-2024,2.1,-2.1,8546103.0,PCS,Issue to Patient,1.0,1.58003,-1.58003,2449.0,3869.49768
6590020029,MAGNESIUM SULPHATE 50% INJ -5ML,Medicine,Rayan Hospital,RYN_IP,,,,1117001003,13-01-2024,2.1,-2.1,8546103.0,PCS,Issue to Patient,1.0,1.58003,-1.58003,2448.0,3867.91765
6590020029,MAGNESIUM SULPHATE 50% INJ -5ML,Medicine,Rayan Hospital,RYN_IP,,,,1117080130,13-01-2024,2.1,-2.1,8546103.0,PCS,Issue to Patient,1.0,1.58003,-1.58003,2447.0,3866.33762
6590020029,MAGNESIUM SULPHATE 50% INJ -5ML,Medicine,Rayan Hospital,RYN_IP,,,,1117134165,13-01-2024,2.1,-6.3,8546103.0,PCS,Issue to Patient,3.0,1.58003,-4.7401,2444.0,3861.59752
6590020029,MAGNESIUM SULPHATE 50% INJ -5ML,Medicine,Rayan Hospital,RYN_IP,,,,1117163214,13-01-2024,2.1,-2.1,8546103.0,PCS,Issue to Patient,1.0,1.58003,-1.58003,2443.0,3860.01749
6590020029,MAGNESIUM SULPHATE 50% INJ -5ML,Medicine,Rayan Hospital,RYN_IP,,,,1117233976,13-01-2024,2.1,-2.1,8546104.0,PCS,Issue to Patient,1.0,1.58003,-1.58003,2442.0,3858.43746
6590020029,MAGNESIUM SULPHATE 50% INJ -5ML,Medicine,Rayan Hospital,RYN_IP,,,,1117243898,13-01-2024,2.1,-2.1,8546103.0,PCS,Issue to Patient,1.0,1.58003,-1.58003,2441.0,3856.85743
6590020029,MAGNESIUM SULPHATE 50% INJ -5ML,Medicine,Rayan Hospital,RYN_IP,,,,1117387945,13-01-2024,2.1,-2.1,8546103.0,PCS,Issue to Patient,1.0,1.58003,-1.58003,2440.0,3855.2774
6590020029,MAGNESIUM SULPHATE 50% INJ -5ML,Medicine,Rayan Hospital,RYN_IP,,,,1117539430,14-01-2024,2.1,-2.1,8546103.0,PCS,Issue to Patient,1.0,1.58003,-1.58003,2439.0,3853.69736
6590020029,MAGNESIUM SULPHATE 50% INJ -5ML,Medicine,Rayan Hospital,RYN_IP,,,,1117593539,14-01-2024,2.1,-4.2,8546103.0,PCS,Issue to Patient,2.0,1.58003,-3.16006,2437.0,3850.5373
6590020029,MAGNESIUM SULPHATE 50% INJ -5ML,Medicine,Rayan Hospital,RYN_IP,,,,1117632984,14-01-2024,2.1,-2.1,8546103.0,PCS,Issue to Patient,1.0,1.58003,-1.58003,2436.0,3848.95727
6590020029,MAGNESIUM SULPHATE 50% INJ -5ML,Medicine,Rayan Hospital,RYN_IP,,,,1117661363,14-01-2024,2.1,-6.3,8546103.0,PCS,Issue to Patient,3.0,1.58003,-4.7401,2433.0,3844.21717
6590020029,MAGNESIUM SULPHATE 50% INJ -5ML,Medicine,Rayan Hospital,RYN_IP,,,,1117715842,14-01-2024,2.1,-2.1,8546103.0,PCS,Issue to Patient,1.0,1.58003,-1.58003,2432.0,3842.63714
6590020029,MAGNESIUM SULPHATE 50% INJ -5ML,Medicine,Rayan Hospital,RYN_IP,,,,1117740393,14-01-2024,2.1,-2.1,8546103.0,PCS,Issue to Patient,1.0,1.58003,-1.58003,2431.0,3841.05711
6590020029,MAGNESIUM SULPHATE 50% INJ -5ML,Medicine,Rayan Hospital,RYN_IP,,,,1117744654,14-01-2024,2.1,-4.2,8546103.0,PCS,Issue to Patient,2.0,1.58003,-3.16006,2429.0,3837.89705
6590020029,MAGNESIUM SULPHATE 50% INJ -5ML,Medicine,Rayan Hospital,RYN_IP,,,,1117744709,14-01-2024,2.1,-4.2,8546103.0,PCS,Issue to Patient,2.0,1.58003,-3.16006,2427.0,3834.73698
6590020029,MAGNESIUM SULPHATE 50% INJ -5ML,Medicine,Rayan Hospital,RYN_IP,,,,1117753840,14-01-2024,2.1,-2.1,8546103.0,PCS,Issue to Patient,1.0,1.58003,-1.58003,2426.0,3833.15695
6590020029,MAGNESIUM SULPHATE 50% INJ -5ML,Medicine,Rayan Hospital,RYN_IP,,,,1117766047,14-01-2024,2.1,-2.1,8546106.0,PCS,Issue to Patient,1.0,1.58003,-1.58003,2425.0,3831.57692
6590020029,MAGNESIUM SULPHATE 50% INJ -5ML,Medicine,Rayan Hospital,RYN_IP,,,,1117770849,14-01-2024,2.1,-2.1,8546103.0,PCS,Issue to Patient,1.0,1.58003,-1.58003,2424.0,3829.99689
6590020029,MAGNESIUM SULPHATE 50% INJ -5ML,Medicine,Rayan Hospital,RYN_IP,,,,1117771286,14-01-2024,2.1,-2.1,8546106.0,PCS,Issue to Patient,1.0,1.58003,-1.58003,2423.0,3828.41686
6590020029,MAGNESIUM SULPHATE 50% INJ -5ML,Medicine,Rayan Hospital,RYN_IP,,,,1117771435,14-01-2024,2.1,-2.1,8546103.0,PCS,Issue to Patient,1.0,1.58003,-1.58003,2422.0,3826.83682
6590020029,MAGNESIUM SULPHATE 50% INJ -5ML,Medicine,Rayan Hospital,RYN_IP,,,,1117775084,14-01-2024,2.1,-2.1,8546106.0,PCS,Issue to Patient,1.0,1.58003,-1.58003,2421.0,3825.25679
6590020029,MAGNESIUM SULPHATE 50% INJ -5ML,Medicine,Rayan Hospital,RYN_IP,,,,1117777651,14-01-2024,2.1,-2.1,8546106.0,PCS,Issue to Patient,1.0,1.58003,-1.58003,2420.0,3823.67676
6590020029,MAGNESIUM SULPHATE 50% INJ -5ML,Medicine,Rayan Hospital,RYN_IP,,,,1117779989,14-01-2024,2.1,-2.1,8546106.0,PCS,Issue to Patient,1.0,1.58003,-1.58003,2419.0,3822.09673
6590020029,MAGNESIUM SULPHATE 50% INJ -5ML,Medicine,Rayan Hospital,RYN_IP,,,,1117780960,14-01-2024,2.1,-2.1,8546106.0,PCS,Issue to Patient,1.0,1.58003,-1.58003,2418.0,3820.5167
6590020029,MAGNESIUM SULPHATE 50% INJ -5ML,Medicine,Rayan Hospital,RYN_IP,,,,1117852126,14-01-2024,2.1,-6.3,8546103.0,PCS,Issue to Patient,3.0,1.58003,-4.7401,2415.0,3815.7766
6590020029,MAGNESIUM SULPHATE 50% INJ -5ML,Medicine,Rayan Hospital,RYN_IP,,,,1117852981,14-01-2024,2.1,-4.2,8546103.0,PCS,Issue to Patient,2.0,1.58003,-3.16006,2413.0,3812.61654
6590020029,MAGNESIUM SULPHATE 50% INJ -5ML,Medicine,Rayan Hospital,RYN_IP,,,,1117871907,14-01-2024,2.1,-2.1,8546103.0,PCS,Issue to Patient,1.0,1.58003,-1.58003,2412.0,3811.03651
6590020029,MAGNESIUM SULPHATE 50% INJ -5ML,Medicine,Rayan Hospital,RYN_IP,,,,1117879800,14-01-2024,2.1,-4.2,8546103.0,PCS,Issue to Patient,2.0,1.58003,-3.16006,2410.0,3807.87644
6590020029,MAGNESIUM SULPHATE 50% INJ -5ML,Medicine,Rayan Hospital,RYN_IP,,,,1118002984,14-01-2024,2.1,-6.3,8546103.0,PCS,Issue to Patient,3.0,1.58003,-4.7401,2407.0,3803.13635
6590020029,MAGNESIUM SULPHATE 50% INJ -5ML,Medicine,Rayan Hospital,RYN_IP,,,,1118120131,15-01-2024,2.1,-2.1,8546103.0,PCS,Issue to Patient,1.0,1.58003,-1.58003,2406.0,3801.55632
6590020029,MAGNESIUM SULPHATE 50% INJ -5ML,Medicine,Rayan Hospital,RYN_IP,,,,1118129160,15-01-2024,2.1,-4.2,8546103.0,PCS,Issue to Patient,2.0,1.58003,-3.16006,2404.0,3798.39625
6590020029,MAGNESIUM SULPHATE 50% INJ -5ML,Medicine,Rayan Hospital,RYN_IP,,,,1118136653,15-01-2024,2.1,-2.1,8546103.0,PCS,Issue to Patient,1.0,1.58003,-1.58003,2403.0,3796.81622
6590020029,MAGNESIUM SULPHATE 50% INJ -5ML,Medicine,Rayan Hospital,STAGE,Rayan Hospital Clinics,RAY_ER,17454357,1118160084,15-01-2024,2.1,-4.2,8546103.0,PCS,Int Order Direct Ship,2.0,1.58003,-3.16006,2401.0,3793.65616
6590020029,MAGNESIUM SULPHATE 50% INJ -5ML,Medicine,Rayan Hospital,STAGE,Rayan Hospital Clinics,RAY_ER,17455938,1118168017,15-01-2024,2.1,-2.1,8546103.0,PCS,Int Order Direct Ship,1.0,1.58003,-1.58003,2400.0,3792.07613
6590020029,MAGNESIUM SULPHATE 50% INJ -5ML,Medicine,Rayan Hospital,STAGE,Rayan Hospital Clinics,RAY_ER,17455739,1118169504,15-01-2024,2.1,-8.4,8546103.0,PCS,Int Order Direct Ship,4.0,1.58003,-6.32013,2396.0,3785.756
6590020029,MAGNESIUM SULPHATE 50% INJ -5ML,Medicine,Rayan Hospital,RYN_IP,,,,1118331259,15-01-2024,2.1,-2.1,8546103.0,PCS,Issue to Patient,1.0,1.58003,-1.58003,2395.0,3784.17597
6590020029,MAGNESIUM SULPHATE 50% INJ -5ML,Medicine,Rayan Hospital,RYN_IP,,,,1118345302,15-01-2024,2.1,-2.1,8546103.0,PCS,Issue to Patient,1.0,1.58003,-1.58003,2394.0,3782.59594
6590020029,MAGNESIUM SULPHATE 50% INJ -5ML,Medicine,Rayan Hospital,RYN_IP,,,,1118373980,15-01-2024,2.1,-2.1,8546103.0,PCS,Issue to Patient,1.0,1.58003,-1.58003,2393.0,3781.0159
6590020029,MAGNESIUM SULPHATE 50% INJ -5ML,Medicine,Rayan Hospital,RYN_IP,,,,1118375318,15-01-2024,2.1,-2.1,8546103.0,PCS,Issue to Patient,1.0,1.58003,-1.58003,2392.0,3779.43587
6590020029,MAGNESIUM SULPHATE 50% INJ -5ML,Medicine,Rayan Hospital,RYN_IP,,,,1118377507,15-01-2024,2.1,-2.1,8546103.0,PCS,Issue to Patient,1.0,1.58003,-1.58003,2391.0,3777.85584
6590020029,MAGNESIUM SULPHATE 50% INJ -5ML,Medicine,Rayan Hospital,RYN_IP,,,,1118378112,15-01-2024,2.1,-2.1,8546103.0,PCS,Issue to Patient,1.0,1.58003,-1.58003,2390.0,3776.27581
6590020029,MAGNESIUM SULPHATE 50% INJ -5ML,Medicine,Rayan Hospital,RYN_IP,,,,1118380637,15-01-2024,2.1,-2.1,8546103.0,PCS,Issue to Patient,1.0,1.58003,-1.58003,2389.0,3774.69578
6590020029,MAGNESIUM SULPHATE 50% INJ -5ML,Medicine,Rayan Hospital,RYN_IP,,,,1118451661,15-01-2024,2.1,-4.2,8546103.0,PCS,Issue to Patient,2.0,1.58003,-3.16006,2387.0,3771.53571
6590020029,MAGNESIUM SULPHATE 50% INJ -5ML,Medicine,Rayan Hospital,RYN_IP,,,,1118475239,15-01-2024,2.1,-2.1,8546103.0,PCS,Issue to Patient,1.0,1.58003,-1.58003,2386.0,3769.95568
6590020029,MAGNESIUM SULPHATE 50% INJ -5ML,Medicine,Rayan Hospital,RYN_IP,,,,1118544788,15-01-2024,2.1,-6.3,8546103.0,PCS,Issue to Patient,3.0,1.58003,-4.7401,2383.0,3765.21559
6590020029,MAGNESIUM SULPHATE 50% INJ -5ML,Medicine,Rayan Hospital,RYN_IP,,,,1118689213,15-01-2024,2.1,-8.4,8546103.0,PCS,Issue to Patient,4.0,1.58003,-6.32013,2379.0,3758.89546
6590020029,MAGNESIUM SULPHATE 50% INJ -5ML,Medicine,Rayan Hospital,RYN_IP,,,,1118741642,16-01-2024,2.1,-2.1,8546103.0,PCS,Issue to Patient,1.0,1.58003,-1.58003,2378.0,3757.31543
6590020029,MAGNESIUM SULPHATE 50% INJ -5ML,Medicine,Rayan Hospital,RYN_IP,,,,1118765777,16-01-2024,2.1,-2.1,8546103.0,PCS,Issue to Patient,1.0,1.58003,-1.58003,2378.0,3757.31543
6590020029,MAGNESIUM SULPHATE 50% INJ -5ML,Medicine,Rayan Hospital,RYN_IP,,,,1118804997,16-01-2024,2.1,-2.1,8546103.0,PCS,Issue to Patient,1.0,1.58003,-1.58003,2377.0,3755.7354
6590020029,MAGNESIUM SULPHATE 50% INJ -5ML,Medicine,Rayan Hospital,RYN_IP,,,,1118861545,16-01-2024,2.1,-4.2,8546103.0,PCS,Issue to Patient,2.0,1.58003,-3.16006,2375.0,3752.57533
6590020029,MAGNESIUM SULPHATE 50% INJ -5ML,Medicine,Rayan Hospital,RYN_IP,,,,1118861726,16-01-2024,2.1,-4.2,8546103.0,PCS,Issue to Patient,2.0,1.58003,-3.16006,2373.0,3749.41527
6590020029,MAGNESIUM SULPHATE 50% INJ -5ML,Medicine,Rayan Hospital,RYN_IP,,,,1119000305,16-01-2024,2.1,-2.1,8546106.0,PCS,Issue to Patient,1.0,1.58003,-1.58003,2372.0,3747.83524
6590020029,MAGNESIUM SULPHATE 50% INJ -5ML,Medicine,Rayan Hospital,RYN_IP,,,,1119002482,16-01-2024,2.1,-2.1,8546103.0,PCS,Issue to Patient,1.0,1.58003,-1.58003,2371.0,3746.25521
6590020029,MAGNESIUM SULPHATE 50% INJ -5ML,Medicine,Rayan Hospital,RYN_IP,,,,1119005228,16-01-2024,2.1,-2.1,8546103.0,PCS,Issue to Patient,1.0,1.58003,-1.58003,2370.0,3744.67518
6590020029,MAGNESIUM SULPHATE 50% INJ -5ML,Medicine,Rayan Hospital,RYN_IP,,,,1119007938,16-01-2024,2.1,-2.1,8546106.0,PCS,Issue to Patient,1.0,1.58003,-1.58003,2369.0,3743.09514
6590020029,MAGNESIUM SULPHATE 50% INJ -5ML,Medicine,Rayan Hospital,RYN_IP,,,,1119019604,16-01-2024,2.1,-6.3,8546103.0,PCS,Issue to Patient,3.0,1.58003,-4.7401,2366.0,3738.35505
6590020029,MAGNESIUM SULPHATE 50% INJ -5ML,Medicine,Rayan Hospital,RYN_IP,,,,1119134227,16-01-2024,2.1,-4.2,8546103.0,PCS,Issue to Patient,2.0,1.58003,-3.16006,2364.0,3735.19498
6590020029,MAGNESIUM SULPHATE 50% INJ -5ML,Medicine,Rayan Hospital,RYN_IP,,,,1119298601,16-01-2024,2.1,-2.1,8546103.0,PCS,Issue to Patient,1.0,1.58003,-1.58003,2363.0,3733.61495
6590020029,MAGNESIUM SULPHATE 50% INJ -5ML,Medicine,Rayan Hospital,RYN_IP,,,,1119320592,16-01-2024,2.1,-2.1,8546103.0,PCS,Issue to Patient,1.0,1.58003,-1.58003,2362.0,3732.03492
6590020029,MAGNESIUM SULPHATE 50% INJ -5ML,Medicine,Rayan Hospital,RYN_IP,,,,1119375919,17-01-2024,2.1,-2.1,8546103.0,PCS,Issue to Patient,1.0,1.58003,-1.58003,2361.0,3730.45489
6590020029,MAGNESIUM SULPHATE 50% INJ -5ML,Medicine,Rayan Hospital,RYN_IP,,,,1119396609,17-01-2024,2.1,-4.2,8546103.0,PCS,Issue to Patient,2.0,1.58003,-3.16006,2359.0,3727.29483
6590020029,MAGNESIUM SULPHATE 50% INJ -5ML,Medicine,Rayan Hospital,RYN_IP,,,,1119457331,17-01-2024,2.1,-4.2,8546103.0,PCS,Issue to Patient,2.0,1.58003,-3.16006,2357.0,3724.13476
6590020029,MAGNESIUM SULPHATE 50% INJ -5ML,Medicine,Rayan Hospital,RYN_IP,,,,1119475725,17-01-2024,2.1,-2.1,8546103.0,PCS,Issue to Patient,1.0,1.58003,-1.58003,2356.0,3722.55473
6590020029,MAGNESIUM SULPHATE 50% INJ -5ML,Medicine,Rayan Hospital,RYN_IP,,,,1119489729,17-01-2024,2.1,-4.2,8546103.0,PCS,Issue to Patient,2.0,1.58003,-3.16006,2354.0,3719.39467
6590020029,MAGNESIUM SULPHATE 50% INJ -5ML,Medicine,Rayan Hospital,RYN_IP,,,,1119498533,17-01-2024,2.1,-2.1,8546103.0,PCS,Issue to Patient,1.0,1.58003,-1.58003,2353.0,3717.81464
6590020029,MAGNESIUM SULPHATE 50% INJ -5ML,Medicine,Rayan Hospital,RYN_IP,Rayan Main Pharmacy,RYN_MP,RAY28110,1119512222,17-01-2024,2.1,-94.5,8546103.0,PCS,Intransit Shipment,45.0,1.58003,-71.10143,2308.0,3646.71321
6590020029,MAGNESIUM SULPHATE 50% INJ -5ML,Medicine,Rayan Hospital,RYN_IP,,,,1119517817,17-01-2024,2.1,-4.2,8546103.0,PCS,Issue to Patient,2.0,1.58003,-3.16006,2306.0,3643.55315
6590020029,MAGNESIUM SULPHATE 50% INJ -5ML,Medicine,Rayan Hospital,RYN_IP,,,,1119597186,17-01-2024,2.1,-2.1,8546103.0,PCS,Issue to Patient,1.0,1.58003,-1.58003,2305.0,3641.97311
6590020029,MAGNESIUM SULPHATE 50% INJ -5ML,Medicine,Rayan Hospital,RYN_IP,,,,1119599217,17-01-2024,2.1,-2.1,8546103.0,PCS,Issue to Patient,1.0,1.58003,-1.58003,2304.0,3640.39308
6590020029,MAGNESIUM SULPHATE 50% INJ -5ML,Medicine,Rayan Hospital,RYN_IP,,,,1119759801,17-01-2024,2.1,-2.1,8546103.0,PCS,Issue to Patient,1.0,1.58003,-1.58003,2303.0,3638.81305
6590020029,MAGNESIUM SULPHATE 50% INJ -5ML,Medicine,Rayan Hospital,RYN_IP,,,,1119759806,17-01-2024,2.1,-2.1,8546103.0,PCS,Issue to Patient,1.0,1.58003,-1.58003,2302.0,3637.23302
6590020029,MAGNESIUM SULPHATE 50% INJ -5ML,Medicine,Rayan Hospital,RYN_IP,,,,1119897768,17-01-2024,2.1,-2.1,8546103.0,PCS,Issue to Patient,1.0,1.58003,-1.58003,2301.0,3635.65299
6590020029,MAGNESIUM SULPHATE 50% INJ -5ML,Medicine,Rayan Hospital,RYN_IP,,,,1120012349,18-01-2024,2.1,-4.2,8546103.0,PCS,Issue to Patient,2.0,1.58003,-3.16006,2299.0,3632.49292
6590020029,MAGNESIUM SULPHATE 50% INJ -5ML,Medicine,Rayan Hospital,RYN_IP,,,,1120027692,18-01-2024,2.1,-2.1,8546103.0,PCS,Issue to Patient,1.0,1.58003,-1.58003,2298.0,3630.91289
6590020029,MAGNESIUM SULPHATE 50% INJ -5ML,Medicine,Rayan Hospital,RYN_IP,,,,1120088506,18-01-2024,2.1,-4.2,8546103.0,PCS,Issue to Patient,2.0,1.58003,-3.16006,2296.0,3627.75283
6590020029,MAGNESIUM SULPHATE 50% INJ -5ML,Medicine,Rayan Hospital,RYN_IP,,,,1120248301,18-01-2024,2.1,-2.1,8546106.0,PCS,Issue to Patient,1.0,1.58003,-1.58003,2295.0,3626.1728
6590020029,MAGNESIUM SULPHATE 50% INJ -5ML,Medicine,Rayan Hospital,RYN_IP,,,,1120396341,18-01-2024,2.1,-4.2,8546103.0,PCS,Issue to Patient,2.0,1.58003,-3.16006,2293.0,3623.01273
6590020029,MAGNESIUM SULPHATE 50% INJ -5ML,Medicine,Rayan Hospital,RYN_IP,,,,1120493643,18-01-2024,2.1,-4.2,8546103.0,PCS,Issue to Patient,2.0,1.58003,-3.16006,2291.0,3619.85267
6590020029,MAGNESIUM SULPHATE 50% INJ -5ML,Medicine,Rayan Hospital,STAGE,Rayan Hospital Clinics,RAY_ER,17458407,1120587188,19-01-2024,2.1,-2.1,8546103.0,PCS,Int Order Direct Ship,1.0,1.58003,-1.58003,2290.0,3618.27264
6590020029,MAGNESIUM SULPHATE 50% INJ -5ML,Medicine,Rayan Hospital,RYN_IP,,,,1120605236,19-01-2024,2.1,-2.1,8546103.0,PCS,Issue to Patient,1.0,1.58003,-1.58003,2289.0,3616.69261
6590020029,MAGNESIUM SULPHATE 50% INJ -5ML,Medicine,Rayan Hospital,RYN_IP,,,,1120609820,19-01-2024,2.1,-4.2,8546103.0,PCS,Issue to Patient,2.0,1.58003,-3.16006,2287.0,3613.53254
6590020029,MAGNESIUM SULPHATE 50% INJ -5ML,Medicine,Rayan Hospital,RYN_IP,,,,1120618043,19-01-2024,2.1,-4.2,8546103.0,PCS,Issue to Patient,2.0,1.58003,-3.16006,2285.0,3610.37248
6590020029,MAGNESIUM SULPHATE 50% INJ -5ML,Medicine,Rayan Hospital,RYN_IP,,,,1120619179,19-01-2024,2.1,-4.2,8546103.0,PCS,Issue to Patient,2.0,1.58003,-3.16006,2283.0,3607.21242
6590020029,MAGNESIUM SULPHATE 50% INJ -5ML,Medicine,Rayan Hospital,RYN_IP,,,,1120623904,19-01-2024,2.1,-4.2,8546103.0,PCS,Issue to Patient,2.0,1.58003,-3.16006,2281.0,3604.05235
6590020029,MAGNESIUM SULPHATE 50% INJ -5ML,Medicine,Rayan Hospital,RYN_IP,,,,1120626224,19-01-2024,2.1,-4.2,8546103.0,PCS,Issue to Patient,2.0,1.58003,-3.16006,2279.0,3600.89229
6590020029,MAGNESIUM SULPHATE 50% INJ -5ML,Medicine,Rayan Hospital,RYN_IP,,,,1120630716,19-01-2024,2.1,-4.2,8546103.0,PCS,Issue to Patient,2.0,1.58003,-3.16006,2277.0,3597.73223
6590020029,MAGNESIUM SULPHATE 50% INJ -5ML,Medicine,Rayan Hospital,RYN_IP,,,,1120631245,19-01-2024,2.1,-4.2,8546103.0,PCS,Issue to Patient,2.0,1.58003,-3.16006,2275.0,3594.57216
6590020029,MAGNESIUM SULPHATE 50% INJ -5ML,Medicine,Rayan Hospital,RYN_IP,,,,1120637470,19-01-2024,2.1,-2.1,8546103.0,PCS,Issue to Patient,1.0,1.58003,-1.58003,2274.0,3592.99213
6590020029,MAGNESIUM SULPHATE 50% INJ -5ML,Medicine,Rayan Hospital,RYN_IP,,,,1120645407,19-01-2024,2.1,-4.2,8546106.0,PCS,Issue to Patient,2.0,1.58003,-3.16006,2272.0,3589.83207
6590020029,MAGNESIUM SULPHATE 50% INJ -5ML,Medicine,Rayan Hospital,RYN_IP,,,,1120672556,19-01-2024,2.1,-2.1,8546103.0,PCS,Issue to Patient,1.0,1.58003,-1.58003,2271.0,3588.25203
6590020029,MAGNESIUM SULPHATE 50% INJ -5ML,Medicine,Rayan Hospital,RYN_IP,,,,1120675468,19-01-2024,2.1,-2.1,8546103.0,PCS,Issue to Patient,1.0,1.58003,-1.58003,2270.0,3586.672
6590020029,MAGNESIUM SULPHATE 50% INJ -5ML,Medicine,Rayan Hospital,RYN_IP,,,,1120676088,19-01-2024,2.1,-2.1,8546103.0,PCS,Issue to Patient,1.0,1.58003,-1.58003,2269.0,3585.09197
6590020029,MAGNESIUM SULPHATE 50% INJ -5ML,Medicine,Rayan Hospital,RYN_IP,,,,1120678160,19-01-2024,2.1,-2.1,8546103.0,PCS,Issue to Patient,1.0,1.58003,-1.58003,2268.0,3583.51194
6590020029,MAGNESIUM SULPHATE 50% INJ -5ML,Medicine,Rayan Hospital,RYN_IP,,,,1120779753,20-01-2024,2.1,-2.1,8546103.0,PCS,Issue to Patient,1.0,1.58003,-1.58003,2267.0,3581.93191
6590020029,MAGNESIUM SULPHATE 50% INJ -5ML,Medicine,Rayan Hospital,RYN_IP,,,,1120805029,20-01-2024,2.1,-4.2,8546103.0,PCS,Issue to Patient,2.0,1.58003,-3.16006,2265.0,3578.77184
6590020029,MAGNESIUM SULPHATE 50% INJ -5ML,Medicine,Rayan Hospital,RYN_IP,,,,1120823264,20-01-2024,2.1,-2.1,8546103.0,PCS,Issue to Patient,1.0,1.58003,-1.58003,2264.0,3577.19181
6590020029,MAGNESIUM SULPHATE 50% INJ -5ML,Medicine,Rayan Hospital,RYN_IP,,,,1120859456,20-01-2024,2.1,-4.2,8546103.0,PCS,Issue to Patient,2.0,1.58003,-3.16006,2262.0,3574.03175
6590020029,MAGNESIUM SULPHATE 50% INJ -5ML,Medicine,Rayan Hospital,RYN_IP,,,,1120866949,20-01-2024,2.1,-4.2,8546103.0,PCS,Issue to Patient,2.0,1.58003,-3.16006,2260.0,3570.87169
6590020029,MAGNESIUM SULPHATE 50% INJ -5ML,Medicine,Rayan Hospital,RYN_IP,,,,1120989335,20-01-2024,2.1,-2.1,8546105.0,PCS,Issue to Patient,1.0,1.58003,-1.58003,2259.0,3569.29165
6590020029,MAGNESIUM SULPHATE 50% INJ -5ML,Medicine,Rayan Hospital,RYN_IP,,,,1120994893,20-01-2024,2.1,-2.1,8546105.0,PCS,Issue to Patient,1.0,1.58003,-1.58003,2258.0,3567.71162
6590020029,MAGNESIUM SULPHATE 50% INJ -5ML,Medicine,Rayan Hospital,STAGE,Rayan Hospital Clinics,RAY_ANSTHA,17460160,1121059527,20-01-2024,2.1,-21.0,8546103.0,PCS,Int Order Direct Ship,10.0,1.58003,-15.80032,2248.0,3551.91131
6590020029,MAGNESIUM SULPHATE 50% INJ -5ML,Medicine,Rayan Hospital,RYN_IP,,,,1121301903,20-01-2024,2.1,-4.2,8546103.0,PCS,Issue to Patient,2.0,1.58003,-3.16006,2246.0,3548.75124
6590020029,MAGNESIUM SULPHATE 50% INJ -5ML,Medicine,Rayan Hospital,RYN_IP,,,,1121312322,20-01-2024,2.1,-2.1,8546103.0,PCS,Issue to Patient,1.0,1.58003,-1.58003,2245.0,3547.17121
6590020029,MAGNESIUM SULPHATE 50% INJ -5ML,Medicine,Rayan Hospital,RYN_IP,,,,1121347940,20-01-2024,2.1,-8.4,8546103.0,PCS,Issue to Patient,4.0,1.58003,-6.32013,2241.0,3540.85108
6590020029,MAGNESIUM SULPHATE 50% INJ -5ML,Medicine,Rayan Hospital,RYN_IP,,,,1121468551,21-01-2024,2.1,-2.1,8546104.0,PCS,Issue to Patient,1.0,1.58003,-1.58003,2240.0,3539.27105
6590020029,MAGNESIUM SULPHATE 50% INJ -5ML,Medicine,Rayan Hospital,STAGE,Rayan Hospital Clinics,RAY_ER,17460166,1121469078,21-01-2024,2.1,-4.2,8546103.0,PCS,Int Order Direct Ship,2.0,1.58003,-3.16006,2238.0,3536.11099
6590020029,MAGNESIUM SULPHATE 50% INJ -5ML,Medicine,Rayan Hospital,RYN_IP,,,,1121559290,21-01-2024,2.1,-2.1,8546103.0,PCS,Issue to Patient,1.0,1.58003,-1.58003,2237.0,3534.53096
6590020029,MAGNESIUM SULPHATE 50% INJ -5ML,Medicine,Rayan Hospital,RYN_IP,,,,1121612759,21-01-2024,2.1,-2.1,8546103.0,PCS,Issue to Patient,1.0,1.58003,-1.58003,2236.0,3532.95092
6590020029,MAGNESIUM SULPHATE 50% INJ -5ML,Medicine,Rayan Hospital,RYN_IP,,,,1121612829,21-01-2024,2.1,-2.1,8546103.0,PCS,Issue to Patient,1.0,1.58003,-1.58003,2235.0,3531.37089
6590020029,MAGNESIUM SULPHATE 50% INJ -5ML,Medicine,Rayan Hospital,RYN_IP,,,,1121613697,21-01-2024,2.1,-2.1,8546103.0,PCS,Issue to Patient,1.0,1.58003,-1.58003,2234.0,3529.79086
6590020029,MAGNESIUM SULPHATE 50% INJ -5ML,Medicine,Rayan Hospital,RYN_IP,,,,1121644322,21-01-2024,2.1,-2.1,8546103.0,PCS,Issue to Patient,1.0,1.58003,-1.58003,2233.0,3528.21083
6590020029,MAGNESIUM SULPHATE 50% INJ -5ML,Medicine,Rayan Hospital,RYN_IP,,,,1121713992,21-01-2024,2.1,-2.1,8546103.0,PCS,Issue to Patient,1.0,1.58003,-1.58003,2232.0,3526.6308
6590020029,MAGNESIUM SULPHATE 50% INJ -5ML,Medicine,Rayan Hospital,RYN_IP,,,,1121730987,21-01-2024,2.1,-2.1,8546103.0,PCS,Issue to Patient,1.0,1.58003,-1.58003,2231.0,3525.05077
6590020029,MAGNESIUM SULPHATE 50% INJ -5ML,Medicine,Rayan Hospital,RYN_IP,,,,1121745551,21-01-2024,2.1,-4.2,8546103.0,PCS,Issue to Patient,2.0,1.58003,-3.16006,2230.0,3523.47073
6590020029,MAGNESIUM SULPHATE 50% INJ -5ML,Medicine,Rayan Hospital,RYN_IP,,,,1121763026,21-01-2024,2.1,-2.1,8546103.0,PCS,Issue to Patient,1.0,1.58003,-1.58003,2229.0,3521.8907
6590020029,MAGNESIUM SULPHATE 50% INJ -5ML,Medicine,Rayan Hospital,RYN_IP,,,,1121859814,21-01-2024,2.1,-2.1,8546103.0,PCS,Issue to Patient,1.0,1.58003,-1.58003,2228.0,3520.31067
6590020029,MAGNESIUM SULPHATE 50% INJ -5ML,Medicine,Rayan Hospital,RAY_PEDCLN,RYN 11218-Pediatrics,,15488490,1121887721,21-01-2024,2.1,-8.4,8546100.0,PCS,Move Order Issue,4.0,1.58003,-6.32013,2224.0,3513.99054
6590020029,MAGNESIUM SULPHATE 50% INJ -5ML,Medicine,Rayan Hospital,RYN_IP,,,,1121981690,22-01-2024,2.1,-2.1,8546103.0,PCS,Issue to Patient,1.0,1.58003,-1.58003,2223.0,3512.41051
6590020029,MAGNESIUM SULPHATE 50% INJ -5ML,Medicine,Rayan Hospital,RYN_IP,,,,1122034474,22-01-2024,2.1,-2.1,8546103.0,PCS,Issue to Patient,1.0,1.58003,-1.58003,2222.0,3510.83048
6590020029,MAGNESIUM SULPHATE 50% INJ -5ML,Medicine,Rayan Hospital,RYN_IP,,,,1122078718,22-01-2024,2.1,-4.2,8546105.0,PCS,Issue to Patient,2.0,1.58003,-3.16006,2220.0,3507.67042
6590020029,MAGNESIUM SULPHATE 50% INJ -5ML,Medicine,Rayan Hospital,RYN_IP,,,,1122086854,22-01-2024,2.1,-4.2,8546104.0,PCS,Issue to Patient,2.0,1.58003,-3.16006,2218.0,3504.51035
6590020029,MAGNESIUM SULPHATE 50% INJ -5ML,Medicine,Rayan Hospital,RYN_IP,,,,1122089963,22-01-2024,2.1,-4.2,8546104.0,PCS,Issue to Patient,2.0,1.58003,-3.16006,2218.0,3504.51035
6590020029,MAGNESIUM SULPHATE 50% INJ -5ML,Medicine,Rayan Hospital,RYN_IP,,,,1122169251,22-01-2024,2.1,-2.1,8546103.0,PCS,Issue to Patient,1.0,1.58003,-1.58003,2217.0,3502.93032
6590020029,MAGNESIUM SULPHATE 50% INJ -5ML,Medicine,Rayan Hospital,RYN_IP,,,,1122178481,22-01-2024,2.1,-2.1,8546105.0,PCS,Issue to Patient,1.0,1.58003,-1.58003,2216.0,3501.35029
6590020029,MAGNESIUM SULPHATE 50% INJ -5ML,Medicine,Rayan Hospital,RYN_IP,,,,1122192985,22-01-2024,2.1,-2.1,8546103.0,PCS,Issue to Patient,1.0,1.58003,-1.58003,2215.0,3499.77026
6590020029,MAGNESIUM SULPHATE 50% INJ -5ML,Medicine,Rayan Hospital,RYN_IP,,,,1122208595,22-01-2024,2.1,-2.1,8546103.0,PCS,Issue to Patient,1.0,1.58003,-1.58003,2214.0,3498.19023
6590020029,MAGNESIUM SULPHATE 50% INJ -5ML,Medicine,Rayan Hospital,RYN_IP,,,,1122208863,22-01-2024,2.1,-2.1,8546103.0,PCS,Issue to Patient,1.0,1.58003,-1.58003,2213.0,3496.6102
6590020029,MAGNESIUM SULPHATE 50% INJ -5ML,Medicine,Rayan Hospital,RYN_IP,,,,1122211991,22-01-2024,2.1,-2.1,8546103.0,PCS,Issue to Patient,1.0,1.58003,-1.58003,2212.0,3495.03016
6590020029,MAGNESIUM SULPHATE 50% INJ -5ML,Medicine,Rayan Hospital,RYN_IP,,,,1122212077,22-01-2024,2.1,-2.1,8546103.0,PCS,Issue to Patient,1.0,1.58003,-1.58003,2211.0,3493.45013
6590020029,MAGNESIUM SULPHATE 50% INJ -5ML,Medicine,Rayan Hospital,RYN_IP,,,,1122240056,22-01-2024,2.1,-8.4,8546103.0,PCS,Issue to Patient,4.0,1.58003,-6.32013,2207.0,3487.13
6590020029,MAGNESIUM SULPHATE 50% INJ -5ML,Medicine,Rayan Hospital,RYN_IP,,,,1122242593,22-01-2024,2.1,-2.1,8546103.0,PCS,Issue to Patient,1.0,1.58003,-1.58003,2207.0,3487.13
6590020029,MAGNESIUM SULPHATE 50% INJ -5ML,Medicine,Rayan Hospital,RYN_IP,,,,1122254501,22-01-2024,2.1,-2.1,8546106.0,PCS,Issue to Patient,1.0,1.58003,-1.58003,2206.0,3485.54997
6590020029,MAGNESIUM SULPHATE 50% INJ -5ML,Medicine,Rayan Hospital,RYN_IP,,,,1122372938,22-01-2024,2.1,-2.1,8546103.0,PCS,Issue to Patient,1.0,1.58003,-1.58003,2205.0,3483.96994
6590020029,MAGNESIUM SULPHATE 50% INJ -5ML,Medicine,Rayan Hospital,RYN_IP,,,,1122441091,22-01-2024,2.1,-2.1,8546103.0,PCS,Issue to Patient,1.0,1.58003,-1.58003,2204.0,3482.38991
6590020029,MAGNESIUM SULPHATE 50% INJ -5ML,Medicine,Rayan Hospital,RYN_IP,,,,1122447881,22-01-2024,2.1,-2.1,8546103.0,PCS,Issue to Patient,1.0,1.58003,-1.58003,2203.0,3480.80988
6590020029,MAGNESIUM SULPHATE 50% INJ -5ML,Medicine,Rayan Hospital,RYN_IP,,,,1122548453,22-01-2024,2.1,-2.1,8546103.0,PCS,Issue to Patient,1.0,1.58003,-1.58003,2202.0,3479.22985
6590020029,MAGNESIUM SULPHATE 50% INJ -5ML,Medicine,Rayan Hospital,RYN_IP,,,,1122554054,22-01-2024,2.1,-4.2,8546103.0,PCS,Issue to Patient,2.0,1.58003,-3.16006,2200.0,3476.06978
6590020029,MAGNESIUM SULPHATE 50% INJ -5ML,Medicine,Rayan Hospital,RYN_IP,,,,1122556969,22-01-2024,2.1,-2.1,8546103.0,PCS,Issue to Patient,1.0,1.58003,-1.58003,2199.0,3474.48975
6590020029,MAGNESIUM SULPHATE 50% INJ -5ML,Medicine,Rayan Hospital,RYN_IP,,,,1122561581,23-01-2024,2.1,-4.2,8546103.0,PCS,Issue to Patient,2.0,1.58003,-3.16006,2197.0,3471.32969
6590020029,MAGNESIUM SULPHATE 50% INJ -5ML,Medicine,Rayan Hospital,RYN_IP,,,,1122583586,23-01-2024,2.1,-4.2,8546103.0,PCS,Issue to Patient,2.0,1.58003,-3.16006,2195.0,3468.16962
6590020029,MAGNESIUM SULPHATE 50% INJ -5ML,Medicine,Rayan Hospital,RYN_IP,,,,1122600516,23-01-2024,2.1,-6.3,8546103.0,PCS,Issue to Patient,3.0,1.58003,-4.7401,2194.0,3466.58959
6590020029,MAGNESIUM SULPHATE 50% INJ -5ML,Medicine,Rayan Hospital,RYN_IP,,,,1122624314,23-01-2024,2.1,-4.2,8546103.0,PCS,Issue to Patient,2.0,1.58003,-3.16006,2192.0,3463.42953
6590020029,MAGNESIUM SULPHATE 50% INJ -5ML,Medicine,Rayan Hospital,RYN_IP,,,,1122691899,23-01-2024,2.1,-2.1,8546103.0,PCS,Issue to Patient,1.0,1.58003,-1.58003,2191.0,3461.8495
6590020029,MAGNESIUM SULPHATE 50% INJ -5ML,Medicine,Rayan Hospital,RYN_IP,,,,1122730507,23-01-2024,2.1,-4.2,8546103.0,PCS,Issue to Patient,2.0,1.58003,-3.16006,2189.0,3458.68943
6590020029,MAGNESIUM SULPHATE 50% INJ -5ML,Medicine,Rayan Hospital,RYN_IP,,,,1122840548,23-01-2024,2.1,-2.1,8546103.0,PCS,Issue to Patient,1.0,1.58003,-1.58003,2188.0,3457.1094
6590020029,MAGNESIUM SULPHATE 50% INJ -5ML,Medicine,Rayan Hospital,RYN_IP,,,,1122866958,23-01-2024,2.1,-2.1,8546106.0,PCS,Issue to Patient,1.0,1.58003,-1.58003,2187.0,3455.52937
6590020029,MAGNESIUM SULPHATE 50% INJ -5ML,Medicine,Rayan Hospital,RYN_IP,,,,1122869320,23-01-2024,2.1,-2.1,8546105.0,PCS,Issue to Patient,1.0,1.58003,-1.58003,2186.0,3453.94934
6590020029,MAGNESIUM SULPHATE 50% INJ -5ML,Medicine,Rayan Hospital,RYN_IP,,,,1122878508,23-01-2024,2.1,-2.1,8546106.0,PCS,Issue to Patient,1.0,1.58003,-1.58003,2185.0,3452.36931
6590020029,MAGNESIUM SULPHATE 50% INJ -5ML,Medicine,Rayan Hospital,RYN_IP,,,,1122936328,23-01-2024,2.1,-4.2,8546103.0,PCS,Issue to Patient,2.0,1.58003,-3.16006,2183.0,3449.20924
6590020029,MAGNESIUM SULPHATE 50% INJ -5ML,Medicine,Rayan Hospital,RYN_IP,,,,1122936338,23-01-2024,2.1,-8.4,8546103.0,PCS,Issue to Patient,4.0,1.58003,-6.32013,2179.0,3442.88912
6590020029,MAGNESIUM SULPHATE 50% INJ -5ML,Medicine,Rayan Hospital,RYN_IP,,,,1122943210,23-01-2024,2.1,-4.2,8546103.0,PCS,Issue to Patient,2.0,1.58003,-3.16006,2181.0,3446.04918
6590020029,MAGNESIUM SULPHATE 50% INJ -5ML,Medicine,Rayan Hospital,RYN_IP,,,,1122967646,23-01-2024,2.1,-2.1,8546103.0,PCS,Issue to Patient,1.0,1.58003,-1.58003,2180.0,3444.46915
6590020029,MAGNESIUM SULPHATE 50% INJ -5ML,Medicine,Rayan Hospital,RYN_IP,,,,1123062190,23-01-2024,2.1,-2.1,8546103.0,PCS,Issue to Patient,1.0,1.58003,-1.58003,2181.0,3446.04918
6590020029,MAGNESIUM SULPHATE 50% INJ -5ML,Medicine,Rayan Hospital,RYN_IP,,,,1123064876,23-01-2024,2.1,-2.1,8546103.0,PCS,Issue to Patient,1.0,1.58003,-1.58003,2180.0,3444.46915
6590020029,MAGNESIUM SULPHATE 50% INJ -5ML,Medicine,Rayan Hospital,RYN_IP,,,,1123117041,23-01-2024,2.1,-8.4,8546103.0,PCS,Issue to Patient,4.0,1.58003,-6.32013,2176.0,3438.14902
6590020029,MAGNESIUM SULPHATE 50% INJ -5ML,Medicine,Rayan Hospital,RYN_IP,,,,1123153186,23-01-2024,2.1,-2.1,8546103.0,PCS,Issue to Patient,1.0,1.58003,-1.58003,2175.0,3436.56899
6590020029,MAGNESIUM SULPHATE 50% INJ -5ML,Medicine,Rayan Hospital,RYN_IP,,,,1123178337,24-01-2024,2.1,-4.2,8546103.0,PCS,Issue to Patient,2.0,1.58003,-3.16006,2173.0,3433.40893
6590020029,MAGNESIUM SULPHATE 50% INJ -5ML,Medicine,Rayan Hospital,RYN_IP,,,,1123183437,24-01-2024,2.1,-8.4,8546103.0,PCS,Issue to Patient,4.0,1.58003,-6.32013,2169.0,3427.0888
6590020029,MAGNESIUM SULPHATE 50% INJ -5ML,Medicine,Rayan Hospital,RYN_IP,,,,1123186653,24-01-2024,2.1,-2.1,8546103.0,PCS,Issue to Patient,1.0,1.58003,-1.58003,2168.0,3425.50877
6590020029,MAGNESIUM SULPHATE 50% INJ -5ML,Medicine,Rayan Hospital,RYN_IP,,,,1123223966,24-01-2024,2.1,-8.4,8546103.0,PCS,Issue to Patient,4.0,1.58003,-6.32013,2164.0,3419.18864
6590020029,MAGNESIUM SULPHATE 50% INJ -5ML,Medicine,Rayan Hospital,RYN_IP,,,,1123223971,24-01-2024,2.1,-8.4,8546103.0,PCS,Issue to Patient,4.0,1.58003,-6.32013,2160.0,3412.86851
6590020029,MAGNESIUM SULPHATE 50% INJ -5ML,Medicine,Rayan Hospital,RYN_IP,,,,1123276773,24-01-2024,2.1,-2.1,8546103.0,PCS,Issue to Patient,1.0,1.58003,-1.58003,2159.0,3411.28848
6590020029,MAGNESIUM SULPHATE 50% INJ -5ML,Medicine,Rayan Hospital,RYN_IP,,,,1123276783,24-01-2024,2.1,-2.1,8546103.0,PCS,Issue to Patient,1.0,1.58003,-1.58003,2158.0,3409.70845
6590020029,MAGNESIUM SULPHATE 50% INJ -5ML,Medicine,Rayan Hospital,RYN_IP,,,,1123301157,24-01-2024,2.1,-4.2,8546103.0,PCS,Issue to Patient,2.0,1.58003,-3.16006,2156.0,3406.54839
6590020029,MAGNESIUM SULPHATE 50% INJ -5ML,Medicine,Rayan Hospital,RYN_IP,,,,1123307876,24-01-2024,2.1,-4.2,8546103.0,PCS,Issue to Patient,2.0,1.58003,-3.16006,2154.0,3403.38832
6590020029,MAGNESIUM SULPHATE 50% INJ -5ML,Medicine,Rayan Hospital,RYN_IP,,,,1123313865,24-01-2024,2.1,-2.1,8546103.0,PCS,Issue to Patient,1.0,1.58003,-1.58003,2153.0,3401.80829
6590020029,MAGNESIUM SULPHATE 50% INJ -5ML,Medicine,Rayan Hospital,RYN_IP,,,,1123356711,24-01-2024,2.1,-2.1,8546103.0,PCS,Issue to Patient,1.0,1.58003,-1.58003,2152.0,3400.22826
6590020029,MAGNESIUM SULPHATE 50% INJ -5ML,Medicine,Rayan Hospital,RYN_IP,,,,1123397567,24-01-2024,2.1,-2.1,8546106.0,PCS,Issue to Patient,1.0,1.58003,-1.58003,2151.0,3398.64823
6590020029,MAGNESIUM SULPHATE 50% INJ -5ML,Medicine,Rayan Hospital,RYN_IP,,,,1123401335,24-01-2024,2.1,-2.1,8546105.0,PCS,Issue to Patient,1.0,1.58003,-1.58003,2150.0,3397.0682
6590020029,MAGNESIUM SULPHATE 50% INJ -5ML,Medicine,Rayan Hospital,RYN_IP,,,,1123403652,24-01-2024,2.1,-2.1,8546105.0,PCS,Issue to Patient,1.0,1.58003,-1.58003,2149.0,3395.48817
6590020029,MAGNESIUM SULPHATE 50% INJ -5ML,Medicine,Rayan Hospital,RYN_IP,,,,1123405838,24-01-2024,2.1,-4.2,8546103.0,PCS,Issue to Patient,2.0,1.58003,-3.16006,2147.0,3392.3281
6590020029,MAGNESIUM SULPHATE 50% INJ -5ML,Medicine,Rayan Hospital,RYN_IP,,,,1123411818,24-01-2024,2.1,-2.1,8546103.0,PCS,Issue to Patient,1.0,1.58003,-1.58003,2146.0,3390.74807
6590020029,MAGNESIUM SULPHATE 50% INJ -5ML,Medicine,Rayan Hospital,RYN_IP,,,,1123431882,24-01-2024,2.1,-2.1,8546103.0,PCS,Issue to Patient,1.0,1.58003,-1.58003,2145.0,3389.16804
6590020029,MAGNESIUM SULPHATE 50% INJ -5ML,Medicine,Rayan Hospital,RYN_IP,,,,1123433285,24-01-2024,2.1,-4.2,8546103.0,PCS,Issue to Patient,2.0,1.58003,-3.16006,2143.0,3386.00797
6590020029,MAGNESIUM SULPHATE 50% INJ -5ML,Medicine,Rayan Hospital,RAY_SLEEP,RYN 11224-Sleep Disorder Unit,,15496471,1123491014,24-01-2024,2.1,-8.4,8546100.0,PCS,Move Order Issue,4.0,1.58003,-6.32013,2142.0,3384.42794
6590020029,MAGNESIUM SULPHATE 50% INJ -5ML,Medicine,Rayan Hospital,RAY_SLEEP,RYN 11224-Sleep Disorder Unit,,15496471,1123491014,24-01-2024,2.1,-2.1,854678.0,PCS,Move Order Issue,1.0,1.58003,-1.58003,2141.0,3382.84791
6590020029,MAGNESIUM SULPHATE 50% INJ -5ML,Medicine,Rayan Hospital,RYN_IP,,,,1123502299,24-01-2024,2.1,-2.1,8546103.0,PCS,Issue to Patient,1.0,1.58003,-1.58003,2140.0,3381.26788
6590020029,MAGNESIUM SULPHATE 50% INJ -5ML,Medicine,Rayan Hospital,RYN_IP,,,,1123508711,24-01-2024,2.1,-2.1,8546103.0,PCS,Issue to Patient,1.0,1.58003,-1.58003,2139.0,3379.68785
6590020029,MAGNESIUM SULPHATE 50% INJ -5ML,Medicine,Rayan Hospital,RAY_DLYSSU,RYN 11213-Nephrology / Renal Dialysis / Hemodialysis ,,15498374,1123601264,24-01-2024,2.1,-4.2,854693.0,PCS,Move Order Issue,2.0,1.58003,-3.16006,2137.0,3376.52778
6590020029,MAGNESIUM SULPHATE 50% INJ -5ML,Medicine,Rayan Hospital,RYN_IP,,,,1123730640,24-01-2024,2.1,-2.1,8546103.0,PCS,Issue to Patient,1.0,1.58003,-1.58003,2136.0,3374.94775
6590020029,MAGNESIUM SULPHATE 50% INJ -5ML,Medicine,Rayan Hospital,RYN_IP,,,,1123761394,25-01-2024,2.1,-2.1,8546103.0,PCS,Issue to Patient,1.0,1.58003,-1.58003,2135.0,3373.36772
6590020029,MAGNESIUM SULPHATE 50% INJ -5ML,Medicine,Rayan Hospital,RYN_IP,,,,1123807046,25-01-2024,2.1,-4.2,8546103.0,PCS,Issue to Patient,2.0,1.58003,-3.16006,2133.0,3370.20766
6590020029,MAGNESIUM SULPHATE 50% INJ -5ML,Medicine,Rayan Hospital,RYN_IP,,,,1123816608,25-01-2024,2.1,-4.2,8546103.0,PCS,Issue to Patient,2.0,1.58003,-3.16006,2133.0,3370.20766
6590020029,MAGNESIUM SULPHATE 50% INJ -5ML,Medicine,Rayan Hospital,RYN_IP,,,,1123816902,25-01-2024,2.1,-4.2,8546103.0,PCS,Issue to Patient,2.0,1.58003,-3.16006,2131.0,3367.04759
6590020029,MAGNESIUM SULPHATE 50% INJ -5ML,Medicine,Rayan Hospital,RYN_IP,,,,1123817768,25-01-2024,2.1,-2.1,8546103.0,PCS,Issue to Patient,1.0,1.58003,-1.58003,2130.0,3365.46756
6590020029,MAGNESIUM SULPHATE 50% INJ -5ML,Medicine,Rayan Hospital,RYN_IP,,,,1123860097,25-01-2024,2.1,-4.2,8546103.0,PCS,Issue to Patient,2.0,1.58003,-3.16006,2128.0,3362.3075
6590020029,MAGNESIUM SULPHATE 50% INJ -5ML,Medicine,Rayan Hospital,RYN_IP,,,,1123865969,25-01-2024,2.1,-8.4,8546103.0,PCS,Issue to Patient,4.0,1.58003,-6.32013,2124.0,3355.98737
6590020029,MAGNESIUM SULPHATE 50% INJ -5ML,Medicine,Rayan Hospital,RYN_IP,,,,1123888436,25-01-2024,2.1,-4.2,8546103.0,PCS,Issue to Patient,2.0,1.58003,-3.16006,2122.0,3352.82731
6590020029,MAGNESIUM SULPHATE 50% INJ -5ML,Medicine,Rayan Hospital,RYN_IP,,,,1123895315,25-01-2024,2.1,-2.1,8546103.0,PCS,Issue to Patient,1.0,1.58003,-1.58003,2121.0,3351.24728
6590020029,MAGNESIUM SULPHATE 50% INJ -5ML,Medicine,Rayan Hospital,RYN_IP,,,,1123899003,25-01-2024,2.1,-2.1,8546103.0,PCS,Issue to Patient,1.0,1.58003,-1.58003,2120.0,3349.66725
6590020029,MAGNESIUM SULPHATE 50% INJ -5ML,Medicine,Rayan Hospital,RYN_IP,,,,1123969472,25-01-2024,2.1,-2.1,8546105.0,PCS,Issue to Patient,1.0,1.58003,-1.58003,2119.0,3348.08721
6590020029,MAGNESIUM SULPHATE 50% INJ -5ML,Medicine,Rayan Hospital,RYN_IP,,,,1123969957,25-01-2024,2.1,-2.1,8546105.0,PCS,Issue to Patient,1.0,1.58003,-1.58003,2118.0,3346.50718
6590020029,MAGNESIUM SULPHATE 50% INJ -5ML,Medicine,Rayan Hospital,RYN_IP,,,,1123996825,25-01-2024,2.1,-2.1,8546105.0,PCS,Issue to Patient,1.0,1.58003,-1.58003,2117.0,3344.92715
6590020029,MAGNESIUM SULPHATE 50% INJ -5ML,Medicine,Rayan Hospital,RYN_IP,,,,1124217673,25-01-2024,2.1,-2.1,8546103.0,PCS,Issue to Patient,1.0,1.58003,-1.58003,2116.0,3343.34712
6590020029,MAGNESIUM SULPHATE 50% INJ -5ML,Medicine,Rayan Hospital,RYN_IP,,,,1124277045,25-01-2024,2.1,-2.1,8546103.0,PCS,Issue to Patient,1.0,1.58003,-1.58003,2117.0,3344.92715
6590020029,MAGNESIUM SULPHATE 50% INJ -5ML,Medicine,Rayan Hospital,RYN_IP,,,,1124333066,26-01-2024,2.1,-2.1,8546103.0,PCS,Issue to Patient,1.0,1.58003,-1.58003,2116.0,3343.34712
6590020029,MAGNESIUM SULPHATE 50% INJ -5ML,Medicine,Rayan Hospital,RYN_IP,,,,1124364284,26-01-2024,2.1,-2.1,8546103.0,PCS,Issue to Patient,1.0,1.58003,-1.58003,2115.0,3341.76709
6590020029,MAGNESIUM SULPHATE 50% INJ -5ML,Medicine,Rayan Hospital,RYN_IP,,,,1124395819,26-01-2024,2.1,-6.3,8546103.0,PCS,Issue to Patient,3.0,1.58003,-4.7401,2112.0,3337.02699
6590020029,MAGNESIUM SULPHATE 50% INJ -5ML,Medicine,Rayan Hospital,RYN_IP,,,,1124408741,26-01-2024,2.1,-2.1,8546103.0,PCS,Issue to Patient,1.0,1.58003,-1.58003,2111.0,3335.44696
6590020029,MAGNESIUM SULPHATE 50% INJ -5ML,Medicine,Rayan Hospital,RYN_IP,,,,1124413086,26-01-2024,2.1,-2.1,8546103.0,PCS,Issue to Patient,1.0,1.58003,-1.58003,2110.0,3333.86693
6590020029,MAGNESIUM SULPHATE 50% INJ -5ML,Medicine,Rayan Hospital,RYN_IP,,,,1124416611,26-01-2024,2.1,-2.1,8546103.0,PCS,Issue to Patient,1.0,1.58003,-1.58003,2109.0,3332.2869
6590020029,MAGNESIUM SULPHATE 50% INJ -5ML,Medicine,Rayan Hospital,RAY_PEDCLN,,,,1124671162,27-01-2024,2.1,-8.4,8546100.0,PCS,Physical Inv Adjust,4.0,1.58003,-6.32013,2105.0,3325.96677
6590020029,MAGNESIUM SULPHATE 50% INJ -5ML,Medicine,Rayan Hospital,RYN_IP,,,,1124682831,27-01-2024,2.1,-2.1,8546103.0,PCS,Issue to Patient,1.0,1.58003,-1.58003,2108.0,3330.70686
6590020029,MAGNESIUM SULPHATE 50% INJ -5ML,Medicine,Rayan Hospital,RYN_IP,,,,1124699828,27-01-2024,2.1,-4.2,8546103.0,PCS,Issue to Patient,2.0,1.58003,-3.16006,2106.0,3327.5468
6590020029,MAGNESIUM SULPHATE 50% INJ -5ML,Medicine,Rayan Hospital,RYN_IP,,,,1124706639,27-01-2024,2.1,-2.1,8546103.0,PCS,Issue to Patient,1.0,1.58003,-1.58003,2105.0,3325.96677
6590020029,MAGNESIUM SULPHATE 50% INJ -5ML,Medicine,Rayan Hospital,RYN_IP,,,,1124750966,27-01-2024,2.1,-4.2,8546103.0,PCS,Issue to Patient,2.0,1.58003,-3.16006,2103.0,3322.80671
6590020029,MAGNESIUM SULPHATE 50% INJ -5ML,Medicine,Rayan Hospital,RYN_IP,,,,1124765271,27-01-2024,2.1,-2.1,8546103.0,PCS,Issue to Patient,1.0,1.58003,-1.58003,2102.0,3321.22667
6590020029,MAGNESIUM SULPHATE 50% INJ -5ML,Medicine,Rayan Hospital,RYN_IP,,,,1124769629,27-01-2024,2.1,-8.4,8546103.0,PCS,Issue to Patient,4.0,1.58003,-6.32013,2098.0,3314.90655
6590020029,MAGNESIUM SULPHATE 50% INJ -5ML,Medicine,Rayan Hospital,RYN_IP,,,,1124796071,27-01-2024,2.1,-4.2,8546103.0,PCS,Issue to Patient,2.0,1.58003,-3.16006,2099.0,3316.48658
6590020029,MAGNESIUM SULPHATE 50% INJ -5ML,Medicine,Rayan Hospital,RYN_IP,,,,1124807923,27-01-2024,2.1,-2.1,8546103.0,PCS,Issue to Patient,1.0,1.58003,-1.58003,2098.0,3314.90655
6590020029,MAGNESIUM SULPHATE 50% INJ -5ML,Medicine,Rayan Hospital,RYN_IP,,,,1124810031,27-01-2024,2.1,-2.1,8546103.0,PCS,Issue to Patient,1.0,1.58003,-1.58003,2097.0,3313.32652
6590020029,MAGNESIUM SULPHATE 50% INJ -5ML,Medicine,Rayan Hospital,RYN_IP,,,,1124810866,27-01-2024,2.1,-2.1,8546103.0,PCS,Issue to Patient,1.0,1.58003,-1.58003,2096.0,3311.74648
6590020029,MAGNESIUM SULPHATE 50% INJ -5ML,Medicine,Rayan Hospital,RYN_IP,,,,1124816201,27-01-2024,2.1,-2.1,8546103.0,PCS,Issue to Patient,1.0,1.58003,-1.58003,2095.0,3310.16645
6590020029,MAGNESIUM SULPHATE 50% INJ -5ML,Medicine,Rayan Hospital,RYN_IP,,,,1124816216,27-01-2024,2.1,-6.3,8546103.0,PCS,Issue to Patient,3.0,1.58003,-4.7401,2092.0,3305.42636
6590020029,MAGNESIUM SULPHATE 50% INJ -5ML,Medicine,Rayan Hospital,RYN_IP,,,,1124828996,27-01-2024,2.1,-2.1,8546103.0,PCS,Issue to Patient,1.0,1.58003,-1.58003,2091.0,3303.84633
6590020029,MAGNESIUM SULPHATE 50% INJ -5ML,Medicine,Rayan Hospital,RYN_IP,,,,1124848852,27-01-2024,2.1,-8.4,8546103.0,PCS,Issue to Patient,4.0,1.58003,-6.32013,2087.0,3297.5262
6590020029,MAGNESIUM SULPHATE 50% INJ -5ML,Medicine,Rayan Hospital,RYN_IP,,,,1124932386,27-01-2024,2.1,-2.1,8546103.0,PCS,Issue to Patient,1.0,1.58003,-1.58003,2086.0,3295.94617
6590020029,MAGNESIUM SULPHATE 50% INJ -5ML,Medicine,Rayan Hospital,RYN_IP,,,,1124964017,27-01-2024,2.1,-4.2,8546103.0,PCS,Issue to Patient,2.0,1.58003,-3.16006,2084.0,3292.7861
6590020029,MAGNESIUM SULPHATE 50% INJ -5ML,Medicine,Rayan Hospital,RYN_IP,,,,1125078588,27-01-2024,2.1,-8.4,8546103.0,PCS,Issue to Patient,4.0,1.58003,-6.32013,2080.0,3286.46598
6590020029,MAGNESIUM SULPHATE 50% INJ -5ML,Medicine,Rayan Hospital,RYN_IP,,,,1125150240,28-01-2024,2.1,-2.1,8546103.0,PCS,Issue to Patient,1.0,1.58003,-1.58003,2079.0,3284.88594
6590020029,MAGNESIUM SULPHATE 50% INJ -5ML,Medicine,Rayan Hospital,RYN_IP,,,,1125152096,28-01-2024,2.1,-2.1,8546103.0,PCS,Issue to Patient,1.0,1.58003,-1.58003,2078.0,3283.30591
6590020029,MAGNESIUM SULPHATE 50% INJ -5ML,Medicine,Rayan Hospital,RYN_IP,,,,1125152161,28-01-2024,2.1,-8.4,8546103.0,PCS,Issue to Patient,4.0,1.58003,-6.32013,2074.0,3276.98579
6590020029,MAGNESIUM SULPHATE 50% INJ -5ML,Medicine,Rayan Hospital,RYN_IP,,,,1125154425,28-01-2024,2.1,-8.4,8546106.0,PCS,Issue to Patient,4.0,1.58003,-6.32013,2070.0,3270.66566
6590020029,MAGNESIUM SULPHATE 50% INJ -5ML,Medicine,Rayan Hospital,STAGE,Rayan Hospital Clinics,RAY_ANSTHA,17466899,1125223526,28-01-2024,2.1,-21.0,8546104.0,PCS,Int Order Direct Ship,10.0,1.58003,-15.80032,2060.0,3254.86534
6590020029,MAGNESIUM SULPHATE 50% INJ -5ML,Medicine,Rayan Hospital,RYN_IP,,,,1125289388,28-01-2024,2.1,-2.1,8546103.0,PCS,Issue to Patient,1.0,1.58003,-1.58003,2059.0,3253.28531
6590020029,MAGNESIUM SULPHATE 50% INJ -5ML,Medicine,Rayan Hospital,RYN_IP,,,,1125292231,28-01-2024,2.1,-2.1,8546103.0,PCS,Issue to Patient,1.0,1.58003,-1.58003,2058.0,3251.70528
6590020029,MAGNESIUM SULPHATE 50% INJ -5ML,Medicine,Rayan Hospital,RYN_IP,,,,1125355143,28-01-2024,2.1,-4.2,8546103.0,PCS,Issue to Patient,2.0,1.58003,-3.16006,2056.0,3248.54522
6590020029,MAGNESIUM SULPHATE 50% INJ -5ML,Medicine,Rayan Hospital,RYN_IP,,,,1125361816,28-01-2024,2.1,-6.3,8546103.0,PCS,Issue to Patient,3.0,1.58003,-4.7401,2053.0,3243.80512
6590020029,MAGNESIUM SULPHATE 50% INJ -5ML,Medicine,Rayan Hospital,RYN_IP,,,,1125365453,28-01-2024,2.1,-2.1,8546103.0,PCS,Issue to Patient,1.0,1.58003,-1.58003,2052.0,3242.22509
6590020029,MAGNESIUM SULPHATE 50% INJ -5ML,Medicine,Rayan Hospital,RYN_IP,,,,1125374240,28-01-2024,2.1,-2.1,8546103.0,PCS,Issue to Patient,1.0,1.58003,-1.58003,2051.0,3240.64506
6590020029,MAGNESIUM SULPHATE 50% INJ -5ML,Medicine,Rayan Hospital,RYN_IP,,,,1125375074,28-01-2024,2.1,-2.1,8546103.0,PCS,Issue to Patient,1.0,1.58003,-1.58003,2050.0,3239.06502
6590020029,MAGNESIUM SULPHATE 50% INJ -5ML,Medicine,Rayan Hospital,RYN_IP,,,,1125380025,28-01-2024,2.1,-4.2,8546104.0,PCS,Issue to Patient,2.0,1.58003,-3.16006,2048.0,3235.90496
6590020029,MAGNESIUM SULPHATE 50% INJ -5ML,Medicine,Rayan Hospital,RYN_IP,,,,1125443299,28-01-2024,2.1,-2.1,8546103.0,PCS,Issue to Patient,1.0,1.58003,-1.58003,2047.0,3234.32493
6590020029,MAGNESIUM SULPHATE 50% INJ -5ML,Medicine,Rayan Hospital,RYN_IP,,,,1125448650,28-01-2024,2.1,-6.3,8546103.0,PCS,Issue to Patient,3.0,1.58003,-4.7401,2044.0,3229.58483
6590020029,MAGNESIUM SULPHATE 50% INJ -5ML,Medicine,Rayan Hospital,RYN_IP,,,,1125546171,28-01-2024,2.1,-2.1,8546103.0,PCS,Issue to Patient,1.0,1.58003,-1.58003,2043.0,3228.0048
6590020029,MAGNESIUM SULPHATE 50% INJ -5ML,Medicine,Rayan Hospital,RYN_IP,,,,1125558101,28-01-2024,2.1,-4.2,8546103.0,PCS,Issue to Patient,2.0,1.58003,-3.16006,2041.0,3224.84474
6590020029,MAGNESIUM SULPHATE 50% INJ -5ML,Medicine,Rayan Hospital,RYN_IP,,,,1125646212,28-01-2024,2.1,-2.1,8546103.0,PCS,Issue to Patient,1.0,1.58003,-1.58003,2040.0,3223.26471
6590020029,MAGNESIUM SULPHATE 50% INJ -5ML,Medicine,Rayan Hospital,RYN_IP,,,,1125797165,29-01-2024,2.1,-8.4,8546103.0,PCS,Issue to Patient,4.0,1.58003,-6.32013,2036.0,3216.94458
6590020029,MAGNESIUM SULPHATE 50% INJ -5ML,Medicine,Rayan Hospital,RYN_IP,,,,1125874012,29-01-2024,2.1,-2.1,8546103.0,PCS,Issue to Patient,1.0,1.58003,-1.58003,2036.0,3216.94458
6590020029,MAGNESIUM SULPHATE 50% INJ -5ML,Medicine,Rayan Hospital,RYN_IP,,,,1125900834,29-01-2024,2.1,-2.1,8546103.0,PCS,Issue to Patient,1.0,1.58003,-1.58003,2035.0,3215.36455
6590020029,MAGNESIUM SULPHATE 50% INJ -5ML,Medicine,Rayan Hospital,RYN_IP,,,,1125906970,29-01-2024,2.1,-2.1,8546103.0,PCS,Issue to Patient,1.0,1.58003,-1.58003,2034.0,3213.78452
6590020029,MAGNESIUM SULPHATE 50% INJ -5ML,Medicine,Rayan Hospital,RYN_IP,,,,1125937055,29-01-2024,2.1,-8.4,8546103.0,PCS,Issue to Patient,4.0,1.58003,-6.32013,2030.0,3207.46439
6590020029,MAGNESIUM SULPHATE 50% INJ -5ML,Medicine,Rayan Hospital,RYN_IP,,,,1125989562,29-01-2024,2.1,-2.1,8546103.0,PCS,Issue to Patient,1.0,1.58003,-1.58003,2029.0,3205.88436
6590020029,MAGNESIUM SULPHATE 50% INJ -5ML,Medicine,Rayan Hospital,RYN_IP,,,,1125990272,29-01-2024,2.1,-2.1,8546103.0,PCS,Issue to Patient,1.0,1.58003,-1.58003,2028.0,3204.30433
6590020029,MAGNESIUM SULPHATE 50% INJ -5ML,Medicine,Rayan Hospital,RYN_IP,,,,1125991874,29-01-2024,2.1,-2.1,8546103.0,PCS,Issue to Patient,1.0,1.58003,-1.58003,2027.0,3202.7243
6590020029,MAGNESIUM SULPHATE 50% INJ -5ML,Medicine,Rayan Hospital,RYN_IP,,,,1126035530,29-01-2024,2.1,-8.4,8546103.0,PCS,Issue to Patient,4.0,1.58003,-6.32013,2023.0,3196.40417
6590020029,MAGNESIUM SULPHATE 50% INJ -5ML,Medicine,Rayan Hospital,RYN_IP,,,,1126043086,29-01-2024,2.1,-4.2,8546103.0,PCS,Issue to Patient,2.0,1.58003,-3.16006,2021.0,3193.24411
6590020029,MAGNESIUM SULPHATE 50% INJ -5ML,Medicine,Rayan Hospital,RYN_IP,,,,1126056342,29-01-2024,2.1,-4.2,8546103.0,PCS,Issue to Patient,2.0,1.58003,-3.16006,2019.0,3190.08404
6590020029,MAGNESIUM SULPHATE 50% INJ -5ML,Medicine,Rayan Hospital,RYN_IP,,,,1126068883,29-01-2024,2.1,-4.2,8546103.0,PCS,Issue to Patient,2.0,1.58003,-3.16006,2017.0,3186.92398
6590020029,MAGNESIUM SULPHATE 50% INJ -5ML,Medicine,Rayan Hospital,RYN_IP,,,,1126206115,29-01-2024,2.1,-4.2,8546103.0,PCS,Issue to Patient,2.0,1.58003,-3.16006,2015.0,3183.76391
6590020029,MAGNESIUM SULPHATE 50% INJ -5ML,Medicine,Rayan Hospital,RYN_IP,,,,1126285191,29-01-2024,2.1,-2.1,8546103.0,PCS,Issue to Patient,1.0,1.58003,-1.58003,2014.0,3182.18388
6590020029,MAGNESIUM SULPHATE 50% INJ -5ML,Medicine,Rayan Hospital,RYN_IP,,,,1126384591,30-01-2024,2.1,-8.4,8546103.0,PCS,Issue to Patient,4.0,1.58003,-6.32013,2010.0,3175.86376
6590020029,MAGNESIUM SULPHATE 50% INJ -5ML,Medicine,Rayan Hospital,RYN_IP,,,,1126391234,30-01-2024,2.1,-4.2,8546105.0,PCS,Issue to Patient,2.0,1.58003,-3.16006,2008.0,3172.70369
6590020029,MAGNESIUM SULPHATE 50% INJ -5ML,Medicine,Rayan Hospital,RYN_IP,,,,1126394695,30-01-2024,2.1,-4.2,8546105.0,PCS,Issue to Patient,2.0,1.58003,-3.16006,2006.0,3169.54363
6590020029,MAGNESIUM SULPHATE 50% INJ -5ML,Medicine,Rayan Hospital,RYN_IP,,,,1126415459,30-01-2024,2.1,-4.2,8546105.0,PCS,Issue to Patient,2.0,1.58003,-3.16006,2004.0,3166.38357
6590020029,MAGNESIUM SULPHATE 50% INJ -5ML,Medicine,Rayan Hospital,RYN_IP,,,,1126430854,30-01-2024,2.1,-6.3,8546103.0,PCS,Issue to Patient,3.0,1.58003,-4.7401,2005.0,3167.9636
6590020029,MAGNESIUM SULPHATE 50% INJ -5ML,Medicine,Rayan Hospital,RYN_IP,,,,1126470525,30-01-2024,2.1,-8.4,8546103.0,PCS,Issue to Patient,4.0,1.58003,-6.32013,2001.0,3161.64347
6590020029,MAGNESIUM SULPHATE 50% INJ -5ML,Medicine,Rayan Hospital,RYN_IP,,,,1126477502,30-01-2024,2.1,-4.2,8546103.0,PCS,Issue to Patient,2.0,1.58003,-3.16006,1999.0,3158.48341
6590020029,MAGNESIUM SULPHATE 50% INJ -5ML,Medicine,Rayan Hospital,RYN_IP,,,,1126484638,30-01-2024,2.1,-2.1,8546103.0,PCS,Issue to Patient,1.0,1.58003,-1.58003,1998.0,3156.90338
6590020029,MAGNESIUM SULPHATE 50% INJ -5ML,Medicine,Rayan Hospital,STAGE,Rayan Hospital Clinics,RAY_ER,17493688,1126532390,30-01-2024,2.1,-6.3,8546104.0,PCS,Int Order Direct Ship,3.0,1.58003,-4.7401,1995.0,3152.16328
6590020029,MAGNESIUM SULPHATE 50% INJ -5ML,Medicine,Rayan Hospital,RYN_IP,,,,1126553877,30-01-2024,2.1,-4.2,8546103.0,PCS,Issue to Patient,2.0,1.58003,-3.16006,1993.0,3149.00322
6590020029,MAGNESIUM SULPHATE 50% INJ -5ML,Medicine,Rayan Hospital,RYN_IP,,,,1126602728,30-01-2024,2.1,-8.4,8546103.0,PCS,Issue to Patient,4.0,1.58003,-6.32013,1989.0,3142.68309
6590020029,MAGNESIUM SULPHATE 50% INJ -5ML,Medicine,Rayan Hospital,RYN_IP,,,,1126604671,30-01-2024,2.1,-2.1,8546103.0,PCS,Issue to Patient,1.0,1.58003,-1.58003,1988.0,3141.10306
6590020029,MAGNESIUM SULPHATE 50% INJ -5ML,Medicine,Rayan Hospital,RYN_IP,,,,1126662992,30-01-2024,2.1,-2.1,8546103.0,PCS,Issue to Patient,1.0,1.58003,-1.58003,1987.0,3139.52303
6590020029,MAGNESIUM SULPHATE 50% INJ -5ML,Medicine,Rayan Hospital,RYN_IP,,,,1126676796,30-01-2024,2.1,-2.1,8546103.0,PCS,Issue to Patient,1.0,1.58003,-1.58003,1986.0,3137.94299
6590020029,MAGNESIUM SULPHATE 50% INJ -5ML,Medicine,Rayan Hospital,RYN_IP,,,,1126682586,30-01-2024,2.1,-2.1,8546103.0,PCS,Issue to Patient,1.0,1.58003,-1.58003,1985.0,3136.36296
6590020029,MAGNESIUM SULPHATE 50% INJ -5ML,Medicine,Rayan Hospital,RYN_IP,,,,1126693182,30-01-2024,2.1,-2.1,8546105.0,PCS,Issue to Patient,1.0,1.58003,-1.58003,1984.0,3134.78293
6590020029,MAGNESIUM SULPHATE 50% INJ -5ML,Medicine,Rayan Hospital,RYN_IP,,,,1126694997,30-01-2024,2.1,-2.1,8546105.0,PCS,Issue to Patient,1.0,1.58003,-1.58003,1983.0,3133.2029
6590020029,MAGNESIUM SULPHATE 50% INJ -5ML,Medicine,Rayan Hospital,RYN_IP,,,,1126699444,30-01-2024,2.1,-2.1,8546105.0,PCS,Issue to Patient,1.0,1.58003,-1.58003,1982.0,3131.62287
6590020029,MAGNESIUM SULPHATE 50% INJ -5ML,Medicine,Rayan Hospital,RYN_IP,,,,1126718699,30-01-2024,2.1,-2.1,8546103.0,PCS,Issue to Patient,1.0,1.58003,-1.58003,1981.0,3130.04284
6590020029,MAGNESIUM SULPHATE 50% INJ -5ML,Medicine,Rayan Hospital,RYN_IP,,,,1126794648,30-01-2024,2.1,-2.1,8546103.0,PCS,Issue to Patient,1.0,1.58003,-1.58003,1980.0,3128.4628
6590020029,MAGNESIUM SULPHATE 50% INJ -5ML,Medicine,Rayan Hospital,RYN_IP,,,,1126798262,30-01-2024,2.1,-2.1,8546103.0,PCS,Issue to Patient,1.0,1.58003,-1.58003,1979.0,3126.88277
6590020029,MAGNESIUM SULPHATE 50% INJ -5ML,Medicine,Rayan Hospital,RYN_IP,,,,1126941084,31-01-2024,2.1,-2.1,8546103.0,PCS,Issue to Patient,1.0,1.58003,-1.58003,1978.0,3125.30274
6590020029,MAGNESIUM SULPHATE 50% INJ -5ML,Medicine,Rayan Hospital,RYN_IP,,,,1126946419,31-01-2024,2.1,-2.1,8546105.0,PCS,Issue to Patient,1.0,1.58003,-1.58003,1977.0,3123.72271
6590020029,MAGNESIUM SULPHATE 50% INJ -5ML,Medicine,Rayan Hospital,RYN_IP,,,,1126964412,31-01-2024,2.1,-4.2,8546103.0,PCS,Issue to Patient,2.0,1.58003,-3.16006,1975.0,3120.56265
6590020029,MAGNESIUM SULPHATE 50% INJ -5ML,Medicine,Rayan Hospital,RYN_IP,,,,1126964417,31-01-2024,2.1,-6.3,8546103.0,PCS,Issue to Patient,3.0,1.58003,-4.7401,1972.0,3115.82255
6590020029,MAGNESIUM SULPHATE 50% INJ -5ML,Medicine,Rayan Hospital,RYN_IP,,,,1126969794,31-01-2024,2.1,-2.1,8546105.0,PCS,Issue to Patient,1.0,1.58003,-1.58003,1971.0,3114.24252
6590020029,MAGNESIUM SULPHATE 50% INJ -5ML,Medicine,Rayan Hospital,RYN_IP,,,,1127051533,31-01-2024,2.1,-4.2,8546103.0,PCS,Issue to Patient,2.0,1.58003,-3.16006,1969.0,3111.08246
6590020029,MAGNESIUM SULPHATE 50% INJ -5ML,Medicine,Rayan Hospital,RYN_IP,,,,1127071773,31-01-2024,2.1,-2.1,8546103.0,PCS,Issue to Patient,1.0,1.58003,-1.58003,1968.0,3109.50242
6590020029,MAGNESIUM SULPHATE 50% INJ -5ML,Medicine,Rayan Hospital,RYN_IP,,,,1127074872,31-01-2024,2.1,-4.2,8546103.0,PCS,Issue to Patient,2.0,1.58003,-3.16006,1966.0,3106.34236
6590020029,MAGNESIUM SULPHATE 50% INJ -5ML,Medicine,Rayan Hospital,RYN_IP,,,,1127141472,31-01-2024,2.1,-2.1,8546103.0,PCS,Issue to Patient,1.0,1.58003,-1.58003,1965.0,3104.76233
6590020029,MAGNESIUM SULPHATE 50% INJ -5ML,Medicine,Rayan Hospital,RYN_IP,,,,1127157764,31-01-2024,2.1,-4.2,8546103.0,PCS,Issue to Patient,2.0,1.58003,-3.16006,1963.0,3101.60227
6590020029,MAGNESIUM SULPHATE 50% INJ -5ML,Medicine,Rayan Hospital,RYN_IP,,,,1127160133,31-01-2024,2.1,-2.1,8546103.0,PCS,Issue to Patient,1.0,1.58003,-1.58003,1962.0,3100.02223
6590020029,MAGNESIUM SULPHATE 50% INJ -5ML,Medicine,Rayan Hospital,RYN_IP,,,,1127174872,31-01-2024,2.1,-2.1,8546103.0,PCS,Issue to Patient,1.0,1.58003,-1.58003,1961.0,3098.4422
6590020029,MAGNESIUM SULPHATE 50% INJ -5ML,Medicine,Rayan Hospital,RYN_IP,,,,1127210222,31-01-2024,2.1,-4.2,8546103.0,PCS,Issue to Patient,2.0,1.58003,-3.16006,1959.0,3095.28214
6590020029,MAGNESIUM SULPHATE 50% INJ -5ML,Medicine,Rayan Hospital,RYN_IP,,,,1127232793,31-01-2024,2.1,-4.2,8546103.0,PCS,Issue to Patient,2.0,1.58003,-3.16006,1957.0,3092.12208
6590020029,MAGNESIUM SULPHATE 50% INJ -5ML,Medicine,Rayan Hospital,RYN_IP,,,,1127256981,31-01-2024,2.1,-2.1,8546103.0,PCS,Issue to Patient,1.0,1.58003,-1.58003,1956.0,3090.54204
6590020029,MAGNESIUM SULPHATE 50% INJ -5ML,Medicine,Rayan Hospital,RYN_IP,,,,1127312715,31-01-2024,2.1,-2.1,8546103.0,PCS,Issue to Patient,1.0,1.58003,-1.58003,1955.0,3088.96201
6590020029,MAGNESIUM SULPHATE 50% INJ -5ML,Medicine,Rayan Hospital,RYN_IP,,,,1127416492,31-01-2024,2.1,-2.1,8546103.0,PCS,Issue to Patient,1.0,1.58003,-1.58003,1954.0,3087.38198
6590020029,MAGNESIUM SULPHATE 50% INJ -5ML,Medicine,Rayan Hospital,RYN_IP,,,,1127450421,31-01-2024,2.1,-4.2,8546103.0,PCS,Issue to Patient,2.0,1.58003,-3.16006,1952.0,3084.22192
6590020029,MAGNESIUM SULPHATE 50% INJ -5ML,Medicine,Rayan Hospital,RYN_IP,,,,1127478780,31-01-2024,2.1,-2.1,8546103.0,PCS,Issue to Patient,1.0,1.58003,-1.58003,1951.0,3082.64188
6590020029,MAGNESIUM SULPHATE 50% INJ -5ML,Medicine,Rayan Hospital,RYN_IP,,,,1127538302,01-02-2024,2.1,-4.2,8546103.0,PCS,Issue to Patient,2.0,1.58003,-3.16006,1949.0,3079.48182
6590020029,MAGNESIUM SULPHATE 50% INJ -5ML,Medicine,Rayan Hospital,STAGE,Rayan Hospital Clinics,RAY_ER,17494747,1127582577,01-02-2024,2.1,-8.4,8546104.0,PCS,Int Order Direct Ship,4.0,1.58003,-6.32013,1945.0,3073.16169
6590020029,MAGNESIUM SULPHATE 50% INJ -5ML,Medicine,Rayan Hospital,RYN_IP,,,,1127623322,01-02-2024,2.1,-2.1,8546103.0,PCS,Issue to Patient,1.0,1.58003,-1.58003,1944.0,3071.58166
6590020029,MAGNESIUM SULPHATE 50% INJ -5ML,Medicine,Rayan Hospital,RYN_IP,,,,1127670667,01-02-2024,2.1,-2.1,8546103.0,PCS,Issue to Patient,1.0,1.58003,-1.58003,1943.0,3070.00163
6590020029,MAGNESIUM SULPHATE 50% INJ -5ML,Medicine,Rayan Hospital,RYN_IP,,,,1127713577,01-02-2024,2.1,-2.1,8546103.0,PCS,Issue to Patient,1.0,1.58003,-1.58003,1943.0,3070.00163
6590020029,MAGNESIUM SULPHATE 50% INJ -5ML,Medicine,Rayan Hospital,RYN_IP,,,,1127750168,01-02-2024,2.1,-2.1,8546103.0,PCS,Issue to Patient,1.0,1.58003,-1.58003,1942.0,3068.4216
6590020029,MAGNESIUM SULPHATE 50% INJ -5ML,Medicine,Rayan Hospital,RYN_IP,,,,1127751779,01-02-2024,2.1,-2.1,8546103.0,PCS,Issue to Patient,1.0,1.58003,-1.58003,1941.0,3066.84157
6590020029,MAGNESIUM SULPHATE 50% INJ -5ML,Medicine,Rayan Hospital,RYN_IP,,,,1127753923,01-02-2024,2.1,-2.1,8546103.0,PCS,Issue to Patient,1.0,1.58003,-1.58003,1940.0,3065.26154
6590020029,MAGNESIUM SULPHATE 50% INJ -5ML,Medicine,Rayan Hospital,RYN_IP,,,,1127772007,01-02-2024,2.1,-2.1,8546103.0,PCS,Issue to Patient,1.0,1.58003,-1.58003,1939.0,3063.6815
6590020029,MAGNESIUM SULPHATE 50% INJ -5ML,Medicine,Rayan Hospital,RYN_IP,,,,1127797197,01-02-2024,2.1,-2.1,8546103.0,PCS,Issue to Patient,1.0,1.58003,-1.58003,1938.0,3062.10147
6590020029,MAGNESIUM SULPHATE 50% INJ -5ML,Medicine,Rayan Hospital,RYN_IP,,,,1127819015,01-02-2024,2.1,-8.4,8546103.0,PCS,Issue to Patient,4.0,1.58003,-6.32013,1934.0,3055.78135
6590020029,MAGNESIUM SULPHATE 50% INJ -5ML,Medicine,Rayan Hospital,RYN_IP,,,,1127826199,01-02-2024,2.1,-4.2,8546103.0,PCS,Issue to Patient,2.0,1.58003,-3.16006,1932.0,3052.62128
6590020029,MAGNESIUM SULPHATE 50% INJ -5ML,Medicine,Rayan Hospital,RYN_IP,,,,1127829385,01-02-2024,2.1,-2.1,8546103.0,PCS,Issue to Patient,1.0,1.58003,-1.58003,1931.0,3051.04125
6590020029,MAGNESIUM SULPHATE 50% INJ -5ML,Medicine,Rayan Hospital,RYN_IP,,,,1127833272,01-02-2024,2.1,-2.1,8546103.0,PCS,Issue to Patient,1.0,1.58003,-1.58003,1930.0,3049.46122
6590020029,MAGNESIUM SULPHATE 50% INJ -5ML,Medicine,Rayan Hospital,RYN_IP,,,,1127943487,01-02-2024,2.1,-4.2,8546103.0,PCS,Issue to Patient,2.0,1.58003,-3.16006,1928.0,3046.30116
6590020029,MAGNESIUM SULPHATE 50% INJ -5ML,Medicine,Rayan Hospital,RYN_IP,,,,1127986237,01-02-2024,2.1,-4.2,8546103.0,PCS,Issue to Patient,2.0,1.58003,-3.16006,1926.0,3043.14109
6590020029,MAGNESIUM SULPHATE 50% INJ -5ML,Medicine,Rayan Hospital,RYN_IP,,,,1127988551,01-02-2024,2.1,-2.1,8546103.0,PCS,Issue to Patient,1.0,1.58003,-1.58003,1925.0,3041.56106
6590020029,MAGNESIUM SULPHATE 50% INJ -5ML,Medicine,Rayan Hospital,RYN_IP,,,,1128033467,02-02-2024,2.1,-4.2,8546103.0,PCS,Issue to Patient,2.0,1.58003,-3.16006,1924.0,3039.98103
6590020029,MAGNESIUM SULPHATE 50% INJ -5ML,Medicine,Rayan Hospital,RYN_IP,,,,1128068709,02-02-2024,2.1,-2.1,8546103.0,PCS,Issue to Patient,1.0,1.58003,-1.58003,1923.0,3038.401
6590020029,MAGNESIUM SULPHATE 50% INJ -5ML,Medicine,Rayan Hospital,RYN_IP,,,,1128097579,02-02-2024,2.1,-2.1,8546103.0,PCS,Issue to Patient,1.0,1.58003,-1.58003,1922.0,3036.82096
6590020029,MAGNESIUM SULPHATE 50% INJ -5ML,Medicine,Rayan Hospital,RYN_IP,,,,1128098716,02-02-2024,2.1,-2.1,8546103.0,PCS,Issue to Patient,1.0,1.58003,-1.58003,1921.0,3035.24093
6590020029,MAGNESIUM SULPHATE 50% INJ -5ML,Medicine,Rayan Hospital,RYN_IP,,,,1128100422,02-02-2024,2.1,-8.4,8546103.0,PCS,Issue to Patient,4.0,1.58003,-6.32013,1917.0,3028.92081
6590020029,MAGNESIUM SULPHATE 50% INJ -5ML,Medicine,Rayan Hospital,RYN_IP,,,,1128102642,02-02-2024,2.1,-2.1,8546103.0,PCS,Issue to Patient,1.0,1.58003,-1.58003,1916.0,3027.34077
6590020029,MAGNESIUM SULPHATE 50% INJ -5ML,Medicine,Rayan Hospital,RYN_IP,,,,1128111152,02-02-2024,2.1,-2.1,8546103.0,PCS,Issue to Patient,1.0,1.58003,-1.58003,1915.0,3025.76074
6590020029,MAGNESIUM SULPHATE 50% INJ -5ML,Medicine,Rayan Hospital,RYN_IP,,,,1128114629,02-02-2024,2.1,-2.1,8546103.0,PCS,Issue to Patient,1.0,1.58003,-1.58003,1914.0,3024.18071
6590020029,MAGNESIUM SULPHATE 50% INJ -5ML,Medicine,Rayan Hospital,RYN_IP,,,,1128161316,02-02-2024,2.1,-2.1,8546106.0,PCS,Issue to Patient,1.0,1.58003,-1.58003,1913.0,3022.60068
6590020029,MAGNESIUM SULPHATE 50% INJ -5ML,Medicine,Rayan Hospital,RYN_IP,,,,1128163179,02-02-2024,2.1,-2.1,8546103.0,PCS,Issue to Patient,1.0,1.58003,-1.58003,1912.0,3021.02065
6590020029,MAGNESIUM SULPHATE 50% INJ -5ML,Medicine,Rayan Hospital,RYN_IP,,,,1128164271,02-02-2024,2.1,-2.1,8546106.0,PCS,Issue to Patient,1.0,1.58003,-1.58003,1911.0,3019.44062
6590020029,MAGNESIUM SULPHATE 50% INJ -5ML,Medicine,Rayan Hospital,RYN_IP,,,,1128164783,02-02-2024,2.1,-2.1,8546105.0,PCS,Issue to Patient,1.0,1.58003,-1.58003,1910.0,3017.86058
6590020029,MAGNESIUM SULPHATE 50% INJ -5ML,Medicine,Rayan Hospital,RYN_IP,,,,1128182801,02-02-2024,2.1,-2.1,8546104.0,PCS,Issue to Patient,1.0,1.58003,-1.58003,1909.0,3016.28055
6590020029,MAGNESIUM SULPHATE 50% INJ -5ML,Medicine,Rayan Hospital,RYN_IP,,,,1128206699,02-02-2024,2.1,-8.4,8546103.0,PCS,Issue to Patient,4.0,1.58003,-6.32013,1905.0,3009.96043
6590020029,MAGNESIUM SULPHATE 50% INJ -5ML,Medicine,Rayan Hospital,RYN_IP,,,,1128234721,02-02-2024,2.1,-2.1,8546103.0,PCS,Issue to Patient,1.0,1.58003,-1.58003,1904.0,3008.38039
6590020029,MAGNESIUM SULPHATE 50% INJ -5ML,Medicine,Rayan Hospital,RYN_IP,,,,1128241381,02-02-2024,2.1,-6.3,8546103.0,PCS,Issue to Patient,3.0,1.58003,-4.7401,1901.0,3003.6403
6590020029,MAGNESIUM SULPHATE 50% INJ -5ML,Medicine,Rayan Hospital,RYN_IP,,,,1128244607,02-02-2024,2.1,-2.1,8546103.0,PCS,Issue to Patient,1.0,1.58003,-1.58003,1900.0,3002.06027
6590020029,MAGNESIUM SULPHATE 50% INJ -5ML,Medicine,Rayan Hospital,RYN_IP,,,,1128282391,02-02-2024,2.1,-2.1,8546103.0,PCS,Issue to Patient,1.0,1.58003,-1.58003,1899.0,3000.48024
6590020029,MAGNESIUM SULPHATE 50% INJ -5ML,Medicine,Rayan Hospital,RYN_IP,,,,1128318466,03-02-2024,2.1,-4.2,8546103.0,PCS,Issue to Patient,2.0,1.58003,-3.16006,1897.0,2997.32017
6590020029,MAGNESIUM SULPHATE 50% INJ -5ML,Medicine,Rayan Hospital,RYN_IP,,,,1128319529,03-02-2024,2.1,-2.1,8546104.0,PCS,Issue to Patient,1.0,1.58003,-1.58003,1896.0,2995.74014
6590020029,MAGNESIUM SULPHATE 50% INJ -5ML,Medicine,Rayan Hospital,RYN_IP,,,,1128324092,03-02-2024,2.1,-2.1,8546103.0,PCS,Issue to Patient,1.0,1.58003,-1.58003,1895.0,2994.16011
6590020029,MAGNESIUM SULPHATE 50% INJ -5ML,Medicine,Rayan Hospital,RYN_IP,,,,1128331345,03-02-2024,2.1,-2.1,8546103.0,PCS,Issue to Patient,1.0,1.58003,-1.58003,1894.0,2992.58008
6590020029,MAGNESIUM SULPHATE 50% INJ -5ML,Medicine,Rayan Hospital,RYN_IP,,,,1128334310,03-02-2024,2.1,-8.4,8546103.0,PCS,Issue to Patient,4.0,1.58003,-6.32013,1890.0,2986.25995
6590020029,MAGNESIUM SULPHATE 50% INJ -5ML,Medicine,Rayan Hospital,RYN_IP,,,,1128343981,03-02-2024,2.1,-4.2,8546103.0,PCS,Issue to Patient,2.0,1.58003,-3.16006,1888.0,2983.09989
6590020029,MAGNESIUM SULPHATE 50% INJ -5ML,Medicine,Rayan Hospital,RYN_IP,,,,1128361270,03-02-2024,2.1,-2.1,8546103.0,PCS,Issue to Patient,1.0,1.58003,-1.58003,1887.0,2981.51985
6590020029,MAGNESIUM SULPHATE 50% INJ -5ML,Medicine,Rayan Hospital,RYN_IP,,,,1128435395,03-02-2024,2.1,-2.1,8546103.0,PCS,Issue to Patient,1.0,1.58003,-1.58003,1886.0,2979.93982
6590020029,MAGNESIUM SULPHATE 50% INJ -5ML,Medicine,Rayan Hospital,RYN_IP,,,,1128435483,03-02-2024,2.1,-8.4,8546103.0,PCS,Issue to Patient,4.0,1.58003,-6.32013,1882.0,2973.6197
6590020029,MAGNESIUM SULPHATE 50% INJ -5ML,Medicine,Rayan Hospital,RYN_IP,,,,1128469808,03-02-2024,2.1,-8.4,8546103.0,PCS,Issue to Patient,4.0,1.58003,-6.32013,1882.0,2973.6197
6590020029,MAGNESIUM SULPHATE 50% INJ -5ML,Medicine,Rayan Hospital,RYN_IP,,,,1128489896,03-02-2024,2.1,-2.1,8546103.0,PCS,Issue to Patient,1.0,1.58003,-1.58003,1881.0,2972.03966
6590020029,MAGNESIUM SULPHATE 50% INJ -5ML,Medicine,Rayan Hospital,RYN_IP,,,,1128497519,03-02-2024,2.1,-2.1,8546103.0,PCS,Issue to Patient,1.0,1.58003,-1.58003,1880.0,2970.45963
6590020029,MAGNESIUM SULPHATE 50% INJ -5ML,Medicine,Rayan Hospital,RYN_IP,,,,1128500729,03-02-2024,2.1,-2.1,8546103.0,PCS,Issue to Patient,1.0,1.58003,-1.58003,1879.0,2968.8796
6590020029,MAGNESIUM SULPHATE 50% INJ -5ML,Medicine,Rayan Hospital,RYN_IP,,,,1128501308,03-02-2024,2.1,-2.1,8546103.0,PCS,Issue to Patient,1.0,1.58003,-1.58003,1878.0,2967.29957
6590020029,MAGNESIUM SULPHATE 50% INJ -5ML,Medicine,Rayan Hospital,RYN_IP,,,,1128503865,03-02-2024,2.1,-2.1,8546103.0,PCS,Issue to Patient,1.0,1.58003,-1.58003,1877.0,2965.71954
6590020029,MAGNESIUM SULPHATE 50% INJ -5ML,Medicine,Rayan Hospital,RYN_IP,,,,1128599747,03-02-2024,2.1,-2.1,8546103.0,PCS,Issue to Patient,1.0,1.58003,-1.58003,1876.0,2964.13951
6590020029,MAGNESIUM SULPHATE 50% INJ -5ML,Medicine,Rayan Hospital,RYN_IP,,,,1128890778,04-02-2024,2.1,-6.3,8546103.0,PCS,Issue to Patient,3.0,1.58003,-4.7401,1873.0,2959.39941
6590020029,MAGNESIUM SULPHATE 50% INJ -5ML,Medicine,Rayan Hospital,RYN_IP,,,,1128891033,04-02-2024,2.1,-8.4,8546103.0,PCS,Issue to Patient,4.0,1.58003,-6.32013,1869.0,2953.07928
6590020029,MAGNESIUM SULPHATE 50% INJ -5ML,Medicine,Rayan Hospital,RYN_IP,,,,1128898099,04-02-2024,2.1,-2.1,8546103.0,PCS,Issue to Patient,1.0,1.58003,-1.58003,1868.0,2951.49925
6590020029,MAGNESIUM SULPHATE 50% INJ -5ML,Medicine,Rayan Hospital,RYN_IP,,,,1129015077,04-02-2024,2.1,-2.1,8546103.0,PCS,Issue to Patient,1.0,1.58003,-1.58003,1867.0,2949.91922
6590020029,MAGNESIUM SULPHATE 50% INJ -5ML,Medicine,Rayan Hospital,RYN_IP,,,,1129158283,04-02-2024,2.1,-8.4,8546103.0,PCS,Issue to Patient,4.0,1.58003,-6.32013,1863.0,2943.59909
6590020029,MAGNESIUM SULPHATE 50% INJ -5ML,Medicine,Rayan Hospital,RYN_IP,,,,1129201267,04-02-2024,2.1,-2.1,8546103.0,PCS,Issue to Patient,1.0,1.58003,-1.58003,1862.0,2942.01906
6590020029,MAGNESIUM SULPHATE 50% INJ -5ML,Medicine,Rayan Hospital,RYN_IP,,,,1129295023,04-02-2024,2.1,-2.1,8546103.0,PCS,Issue to Patient,1.0,1.58003,-1.58003,1862.0,2942.01906
6590020029,MAGNESIUM SULPHATE 50% INJ -5ML,Medicine,Rayan Hospital,RYN_IP,,,,1129328994,04-02-2024,2.1,-2.1,8546103.0,PCS,Issue to Patient,1.0,1.58003,-1.58003,1861.0,2940.43903
6590020029,MAGNESIUM SULPHATE 50% INJ -5ML,Medicine,Rayan Hospital,RYN_IP,,,,1129490381,04-02-2024,2.1,-2.1,8546103.0,PCS,Issue to Patient,1.0,1.58003,-1.58003,1860.0,2938.859
6590020029,MAGNESIUM SULPHATE 50% INJ -5ML,Medicine,Rayan Hospital,RYN_IP,,,,1129539467,05-02-2024,2.1,-8.4,8546103.0,PCS,Issue to Patient,4.0,1.58003,-6.32013,1856.0,2932.53887
6590020029,MAGNESIUM SULPHATE 50% INJ -5ML,Medicine,Rayan Hospital,RYN_IP,,,,1129748685,05-02-2024,2.1,-2.1,8546105.0,PCS,Issue to Patient,1.0,1.58003,-1.58003,1859.0,2937.27897
6590020029,MAGNESIUM SULPHATE 50% INJ -5ML,Medicine,Rayan Hospital,RYN_IP,,,,1129750666,05-02-2024,2.1,-2.1,8546105.0,PCS,Issue to Patient,1.0,1.58003,-1.58003,1858.0,2935.69893
6590020029,MAGNESIUM SULPHATE 50% INJ -5ML,Medicine,Rayan Hospital,RYN_IP,,,,1129750821,05-02-2024,2.1,-2.1,8546105.0,PCS,Issue to Patient,1.0,1.58003,-1.58003,1857.0,2934.1189
6590020029,MAGNESIUM SULPHATE 50% INJ -5ML,Medicine,Rayan Hospital,RYN_IP,,,,1129784001,05-02-2024,2.1,-2.1,8546103.0,PCS,Issue to Patient,1.0,1.58003,-1.58003,1856.0,2932.53887
6590020029,MAGNESIUM SULPHATE 50% INJ -5ML,Medicine,Rayan Hospital,RYN_IP,,,,1129789325,05-02-2024,2.1,-2.1,8546103.0,PCS,Issue to Patient,1.0,1.58003,-1.58003,1855.0,2930.95884
6590020029,MAGNESIUM SULPHATE 50% INJ -5ML,Medicine,Rayan Hospital,RYN_IP,,,,1129794075,05-02-2024,2.1,-2.1,8546105.0,PCS,Issue to Patient,1.0,1.58003,-1.58003,1854.0,2929.37881
6590020029,MAGNESIUM SULPHATE 50% INJ -5ML,Medicine,Rayan Hospital,RYN_IP,,,,1129821895,05-02-2024,2.1,-4.2,8546103.0,PCS,Issue to Patient,2.0,1.58003,-3.16006,1852.0,2926.21874
6590020029,MAGNESIUM SULPHATE 50% INJ -5ML,Medicine,Rayan Hospital,RYN_IP,,,,1130065871,05-02-2024,2.1,-2.1,8546103.0,PCS,Issue to Patient,1.0,1.58003,-1.58003,1851.0,2924.63871
6590020029,MAGNESIUM SULPHATE 50% INJ -5ML,Medicine,Rayan Hospital,RYN_IP,,,,1130118878,06-02-2024,2.1,-2.1,8546104.0,PCS,Issue to Patient,1.0,1.58003,-1.58003,1850.0,2923.05868
6590020029,MAGNESIUM SULPHATE 50% INJ -5ML,Medicine,Rayan Hospital,RYN_IP,,,,1130158482,06-02-2024,2.1,-8.4,8546103.0,PCS,Issue to Patient,4.0,1.58003,-6.32013,1846.0,2916.73855
6590020029,MAGNESIUM SULPHATE 50% INJ -5ML,Medicine,Rayan Hospital,RYN_IP,,,,1130162720,06-02-2024,2.1,-4.2,8546103.0,PCS,Issue to Patient,2.0,1.58003,-3.16006,1844.0,2913.57849
6590020029,MAGNESIUM SULPHATE 50% INJ -5ML,Medicine,Rayan Hospital,RYN_IP,,,,1130193269,06-02-2024,2.1,-2.1,8546103.0,PCS,Issue to Patient,1.0,1.58003,-1.58003,1847.0,2918.31859
6590020029,MAGNESIUM SULPHATE 50% INJ -5ML,Medicine,Rayan Hospital,RYN_IP,,,,1130199866,06-02-2024,2.1,-2.1,8546103.0,PCS,Issue to Patient,1.0,1.58003,-1.58003,1846.0,2916.73855
6590020029,MAGNESIUM SULPHATE 50% INJ -5ML,Medicine,Rayan Hospital,RYN_IP,,,,1130201075,06-02-2024,2.1,-2.1,8546103.0,PCS,Issue to Patient,1.0,1.58003,-1.58003,1845.0,2915.15852
6590020029,MAGNESIUM SULPHATE 50% INJ -5ML,Medicine,Rayan Hospital,RYN_IP,,,,1130203749,06-02-2024,2.1,-2.1,8546103.0,PCS,Issue to Patient,1.0,1.58003,-1.58003,1844.0,2913.57849
6590020029,MAGNESIUM SULPHATE 50% INJ -5ML,Medicine,Rayan Hospital,RYN_IP,,,,1130204850,06-02-2024,2.1,-2.1,8546103.0,PCS,Issue to Patient,1.0,1.58003,-1.58003,1843.0,2911.99846
6590020029,MAGNESIUM SULPHATE 50% INJ -5ML,Medicine,Rayan Hospital,RYN_IP,,,,1130211844,06-02-2024,2.1,-4.2,8546103.0,PCS,Issue to Patient,2.0,1.58003,-3.16006,1841.0,2908.8384
6590020029,MAGNESIUM SULPHATE 50% INJ -5ML,Medicine,Rayan Hospital,RYN_IP,,,,1130273168,06-02-2024,2.1,-2.1,8546103.0,PCS,Issue to Patient,1.0,1.58003,-1.58003,1840.0,2907.25836
6590020029,MAGNESIUM SULPHATE 50% INJ -5ML,Medicine,Rayan Hospital,RYN_IP,,,,1130342774,06-02-2024,2.1,-4.2,8546103.0,PCS,Issue to Patient,2.0,1.58003,-3.16006,1838.0,2904.0983
6590020029,MAGNESIUM SULPHATE 50% INJ -5ML,Medicine,Rayan Hospital,RYN_IP,,,,1130354602,06-02-2024,2.1,-2.1,8546105.0,PCS,Issue to Patient,1.0,1.58003,-1.58003,1837.0,2902.51827
6590020029,MAGNESIUM SULPHATE 50% INJ -5ML,Medicine,Rayan Hospital,RYN_IP,,,,1130355108,06-02-2024,2.1,-2.1,8546105.0,PCS,Issue to Patient,1.0,1.58003,-1.58003,1836.0,2900.93824
6590020029,MAGNESIUM SULPHATE 50% INJ -5ML,Medicine,Rayan Hospital,RYN_IP,,,,1130357751,06-02-2024,2.1,-2.1,8546105.0,PCS,Issue to Patient,1.0,1.58003,-1.58003,1835.0,2899.35821
6590020029,MAGNESIUM SULPHATE 50% INJ -5ML,Medicine,Rayan Hospital,RYN_IP,,,,1130357841,06-02-2024,2.1,-2.1,8546105.0,PCS,Issue to Patient,1.0,1.58003,-1.58003,1834.0,2897.77817
6590020029,MAGNESIUM SULPHATE 50% INJ -5ML,Medicine,Rayan Hospital,RYN_IP,,,,1130402886,06-02-2024,2.1,-2.1,8546103.0,PCS,Issue to Patient,1.0,1.58003,-1.58003,1833.0,2896.19814
6590020029,MAGNESIUM SULPHATE 50% INJ -5ML,Medicine,Rayan Hospital,RYN_IP,,,,1130407972,06-02-2024,2.1,-2.1,8546103.0,PCS,Issue to Patient,1.0,1.58003,-1.58003,1832.0,2894.61811
6590020029,MAGNESIUM SULPHATE 50% INJ -5ML,Medicine,Rayan Hospital,RYN_IP,,,,1130503854,06-02-2024,2.1,-4.2,8546103.0,PCS,Issue to Patient,2.0,1.58003,-3.16006,1830.0,2891.45805
6590020029,MAGNESIUM SULPHATE 50% INJ -5ML,Medicine,Rayan Hospital,RYN_IP,,,,1130526545,06-02-2024,2.1,-2.1,8546106.0,PCS,Issue to Patient,1.0,1.58003,-1.58003,1829.0,2889.87801
6590020029,MAGNESIUM SULPHATE 50% INJ -5ML,Medicine,Rayan Hospital,RYN_IP,,,,1130747939,07-02-2024,2.1,-4.2,8546103.0,PCS,Issue to Patient,2.0,1.58003,-3.16006,1827.0,2886.71795
6590020029,MAGNESIUM SULPHATE 50% INJ -5ML,Medicine,Rayan Hospital,RYN_IP,,,,1130757657,07-02-2024,2.1,-8.4,8546103.0,PCS,Issue to Patient,4.0,1.58003,-6.32013,1823.0,2880.39782
6590020029,MAGNESIUM SULPHATE 50% INJ -5ML,Medicine,Rayan Hospital,RYN_IP,,,,1130815997,07-02-2024,2.1,-4.2,8546103.0,PCS,Issue to Patient,2.0,1.58003,-3.16006,1825.0,2883.55789
6590020029,MAGNESIUM SULPHATE 50% INJ -5ML,Medicine,Rayan Hospital,STAGE,Rayan Hospital Clinics,RAY_ANSTHA,17500955,1130855467,07-02-2024,2.1,-31.5,8546104.0,PCS,Int Order Direct Ship,15.0,1.58003,-23.70048,1810.0,2859.85741
6590020029,MAGNESIUM SULPHATE 50% INJ -5ML,Medicine,Rayan Hospital,RYN_IP,,,,1130868971,07-02-2024,2.1,-4.2,8546103.0,PCS,Issue to Patient,2.0,1.58003,-3.16006,1808.0,2856.69735
6590020029,MAGNESIUM SULPHATE 50% INJ -5ML,Medicine,Rayan Hospital,RYN_IP,,,,1130965842,07-02-2024,2.1,-4.2,8546103.0,PCS,Issue to Patient,2.0,1.58003,-3.16006,1806.0,2853.53729
6590020029,MAGNESIUM SULPHATE 50% INJ -5ML,Medicine,Rayan Hospital,RYN_IP,,,,1130972669,07-02-2024,2.1,-8.4,8546103.0,PCS,Issue to Patient,4.0,1.58003,-6.32013,1802.0,2847.21716
6590020029,MAGNESIUM SULPHATE 50% INJ -5ML,Medicine,Rayan Hospital,RYN_IP,,,,1130983140,07-02-2024,2.1,-2.1,8546105.0,PCS,Issue to Patient,1.0,1.58003,-1.58003,1801.0,2845.63713
6590020029,MAGNESIUM SULPHATE 50% INJ -5ML,Medicine,Rayan Hospital,RYN_IP,,,,1130983200,07-02-2024,2.1,-2.1,8546105.0,PCS,Issue to Patient,1.0,1.58003,-1.58003,1800.0,2844.0571
6590020029,MAGNESIUM SULPHATE 50% INJ -5ML,Medicine,Rayan Hospital,RYN_IP,,,,1130984852,07-02-2024,2.1,-2.1,8546105.0,PCS,Issue to Patient,1.0,1.58003,-1.58003,1799.0,2842.47706
6590020029,MAGNESIUM SULPHATE 50% INJ -5ML,Medicine,Rayan Hospital,RYN_IP,,,,1131023971,07-02-2024,2.1,-8.4,8546104.0,PCS,Issue to Patient,4.0,1.58003,-6.32013,1795.0,2836.15694
6590020029,MAGNESIUM SULPHATE 50% INJ -5ML,Medicine,Rayan Hospital,RYN_IP,,,,1131051597,07-02-2024,2.1,-2.1,8546103.0,PCS,Issue to Patient,1.0,1.58003,-1.58003,1794.0,2834.5769
6590020029,MAGNESIUM SULPHATE 50% INJ -5ML,Medicine,Rayan Hospital,RYN_IP,,,,1131206706,07-02-2024,2.1,-6.3,8546103.0,PCS,Issue to Patient,3.0,1.58003,-4.7401,1791.0,2829.83681
6590020029,MAGNESIUM SULPHATE 50% INJ -5ML,Medicine,Rayan Hospital,RYN_IP,,,,1131291140,07-02-2024,2.1,-8.4,8546103.0,PCS,Issue to Patient,4.0,1.58003,-6.32013,1787.0,2823.51668
6590020029,MAGNESIUM SULPHATE 50% INJ -5ML,Medicine,Rayan Hospital,RYN_IP,,,,1131323431,08-02-2024,2.1,-2.1,8546103.0,PCS,Issue to Patient,1.0,1.58003,-1.58003,1786.0,2821.93665
6590020029,MAGNESIUM SULPHATE 50% INJ -5ML,Medicine,Rayan Hospital,RYN_IP,,,,1131329831,08-02-2024,2.1,-4.2,8546103.0,PCS,Issue to Patient,2.0,1.58003,-3.16006,1784.0,2818.77659
6590020029,MAGNESIUM SULPHATE 50% INJ -5ML,Medicine,Rayan Hospital,RYN_IP,,,,1131349054,08-02-2024,2.1,-4.2,8546103.0,PCS,Issue to Patient,2.0,1.58003,-3.16006,1782.0,2815.61652
6590020029,MAGNESIUM SULPHATE 50% INJ -5ML,Medicine,Rayan Hospital,RYN_IP,,,,1131351542,08-02-2024,2.1,-8.4,8546103.0,PCS,Issue to Patient,4.0,1.58003,-6.32013,1778.0,2809.2964
6590020029,MAGNESIUM SULPHATE 50% INJ -5ML,Medicine,Rayan Hospital,RYN_IP,,,,1131363462,08-02-2024,2.1,-8.4,8546103.0,PCS,Issue to Patient,4.0,1.58003,-6.32013,1774.0,2802.97627
6590020029,MAGNESIUM SULPHATE 50% INJ -5ML,Medicine,Rayan Hospital,RYN_IP,,,,1131389661,08-02-2024,2.1,-8.4,8546103.0,PCS,Issue to Patient,4.0,1.58003,-6.32013,1775.0,2804.5563
6590020029,MAGNESIUM SULPHATE 50% INJ -5ML,Medicine,Rayan Hospital,RYN_IP,,,,1131568742,08-02-2024,2.1,-4.2,8546103.0,PCS,Issue to Patient,2.0,1.58003,-3.16006,1773.0,2801.39624
6590020029,MAGNESIUM SULPHATE 50% INJ -5ML,Medicine,Rayan Hospital,RYN_IP,,,,1131586152,08-02-2024,2.1,-4.2,8546103.0,PCS,Issue to Patient,2.0,1.58003,-3.16006,1771.0,2798.23618
6590020029,MAGNESIUM SULPHATE 50% INJ -5ML,Medicine,Rayan Hospital,RYN_IP,,,,1131606283,08-02-2024,2.1,-4.2,8546103.0,PCS,Issue to Patient,2.0,1.58003,-3.16006,1769.0,2795.07611
6590020029,MAGNESIUM SULPHATE 50% INJ -5ML,Medicine,Rayan Hospital,RYN_IP,,,,1131617894,08-02-2024,2.1,-4.2,8546103.0,PCS,Issue to Patient,2.0,1.58003,-3.16006,1767.0,2791.91605
6590020029,MAGNESIUM SULPHATE 50% INJ -5ML,Medicine,Rayan Hospital,RYN_IP,,,,1131663930,08-02-2024,2.1,-6.3,8546103.0,PCS,Issue to Patient,3.0,1.58003,-4.7401,1764.0,2787.17595
6590020029,MAGNESIUM SULPHATE 50% INJ -5ML,Medicine,Rayan Hospital,RYN_IP,,,,1131687154,08-02-2024,2.1,-2.1,8546105.0,PCS,Issue to Patient,1.0,1.58003,-1.58003,1765.0,2788.75598
6590020029,MAGNESIUM SULPHATE 50% INJ -5ML,Medicine,Rayan Hospital,RYN_IP,,,,1131691868,08-02-2024,2.1,-2.1,8546105.0,PCS,Issue to Patient,1.0,1.58003,-1.58003,1764.0,2787.17595
6590020029,MAGNESIUM SULPHATE 50% INJ -5ML,Medicine,Rayan Hospital,STAGE,Rayan Hospital Clinics,RAY_ER,17501646,1131720035,08-02-2024,2.1,-6.3,8546104.0,PCS,Int Order Direct Ship,3.0,1.58003,-4.7401,1761.0,2782.43586
6590020029,MAGNESIUM SULPHATE 50% INJ -5ML,Medicine,Rayan Hospital,RYN_IP,,,,1131779091,08-02-2024,2.1,-6.3,8546103.0,PCS,Issue to Patient,3.0,1.58003,-4.7401,1758.0,2777.69576
6590020029,MAGNESIUM SULPHATE 50% INJ -5ML,Medicine,Rayan Hospital,RYN_IP,,,,1131791853,08-02-2024,2.1,-4.2,8546103.0,PCS,Issue to Patient,2.0,1.58003,-3.16006,1756.0,2774.5357
6590020029,MAGNESIUM SULPHATE 50% INJ -5ML,Medicine,Rayan Hospital,RYN_IP,,,,1131842677,08-02-2024,2.1,-2.1,8546104.0,PCS,Issue to Patient,1.0,1.58003,-1.58003,1755.0,2772.95567
6590020029,MAGNESIUM SULPHATE 50% INJ -5ML,Medicine,Rayan Hospital,RYN_IP,,,,1131866453,09-02-2024,2.1,-2.1,8546103.0,PCS,Issue to Patient,1.0,1.58003,-1.58003,1754.0,2771.37564
6590020029,MAGNESIUM SULPHATE 50% INJ -5ML,Medicine,Rayan Hospital,RYN_IP,,,,1131894063,09-02-2024,2.1,-2.1,8546103.0,PCS,Issue to Patient,1.0,1.58003,-1.58003,1753.0,2769.7956
6590020029,MAGNESIUM SULPHATE 50% INJ -5ML,Medicine,Rayan Hospital,RYN_IP,,,,1131924056,09-02-2024,2.1,-2.1,8546103.0,PCS,Issue to Patient,1.0,1.58003,-1.58003,1752.0,2768.21557
6590020029,MAGNESIUM SULPHATE 50% INJ -5ML,Medicine,Rayan Hospital,RYN_IP,,,,1131924061,09-02-2024,2.1,-4.2,8546103.0,PCS,Issue to Patient,2.0,1.58003,-3.16006,1750.0,2765.05551
6590020029,MAGNESIUM SULPHATE 50% INJ -5ML,Medicine,Rayan Hospital,RYN_IP,,,,1131982155,09-02-2024,2.1,-4.2,8546103.0,PCS,Issue to Patient,2.0,1.58003,-3.16006,1748.0,2761.89545
6590020029,MAGNESIUM SULPHATE 50% INJ -5ML,Medicine,Rayan Hospital,RYN_IP,,,,1132001583,09-02-2024,2.1,-2.1,8546104.0,PCS,Issue to Patient,1.0,1.58003,-1.58003,1747.0,2760.31541
6590020029,MAGNESIUM SULPHATE 50% INJ -5ML,Medicine,Rayan Hospital,RYN_IP,,,,1132003065,09-02-2024,2.1,-2.1,8546105.0,PCS,Issue to Patient,1.0,1.58003,-1.58003,1746.0,2758.73538
6590020029,MAGNESIUM SULPHATE 50% INJ -5ML,Medicine,Rayan Hospital,RYN_IP,,,,1132006857,09-02-2024,2.1,-2.1,8546106.0,PCS,Issue to Patient,1.0,1.58003,-1.58003,1745.0,2757.15535
6590020029,MAGNESIUM SULPHATE 50% INJ -5ML,Medicine,Rayan Hospital,RYN_IP,,,,1132012757,09-02-2024,2.1,-6.3,8546103.0,PCS,Issue to Patient,3.0,1.58003,-4.7401,1742.0,2752.41526
6590020029,MAGNESIUM SULPHATE 50% INJ -5ML,Medicine,Rayan Hospital,RYN_IP,,,,1132042487,09-02-2024,2.1,-4.2,8546103.0,PCS,Issue to Patient,2.0,1.58003,-3.16006,1740.0,2749.25519
6590020029,MAGNESIUM SULPHATE 50% INJ -5ML,Medicine,Rayan Hospital,RYN_IP,,,,1132153873,10-02-2024,2.1,-6.3,8546103.0,PCS,Issue to Patient,3.0,1.58003,-4.7401,1737.0,2744.5151
6590020029,MAGNESIUM SULPHATE 50% INJ -5ML,Medicine,Rayan Hospital,RYN_IP,,,,1132160270,10-02-2024,2.1,-4.2,8546103.0,PCS,Issue to Patient,2.0,1.58003,-3.16006,1735.0,2741.35503
6590020029,MAGNESIUM SULPHATE 50% INJ -5ML,Medicine,Rayan Hospital,RYN_IP,,,,1132164551,10-02-2024,2.1,-4.2,8546103.0,PCS,Issue to Patient,2.0,1.58003,-3.16006,1733.0,2738.19497
6590020029,MAGNESIUM SULPHATE 50% INJ -5ML,Medicine,Rayan Hospital,RYN_IP,,,,1132494600,10-02-2024,2.1,-2.1,8546103.0,PCS,Issue to Patient,1.0,1.58003,-1.58003,1737.0,2744.5151
6590020029,MAGNESIUM SULPHATE 50% INJ -5ML,Medicine,Rayan Hospital,RYN_IP,,,,1132505350,10-02-2024,2.1,-2.1,8546105.0,PCS,Issue to Patient,1.0,1.58003,-1.58003,1736.0,2742.93507
6590020029,MAGNESIUM SULPHATE 50% INJ -5ML,Medicine,Rayan Hospital,RYN_IP,,,,1132509061,10-02-2024,2.1,-2.1,8546105.0,PCS,Issue to Patient,1.0,1.58003,-1.58003,1735.0,2741.35503
6590020029,MAGNESIUM SULPHATE 50% INJ -5ML,Medicine,Rayan Hospital,RYN_IP,,,,1132513242,10-02-2024,2.1,-2.1,8546106.0,PCS,Issue to Patient,1.0,1.58003,-1.58003,1734.0,2739.775
6590020029,MAGNESIUM SULPHATE 50% INJ -5ML,Medicine,Rayan Hospital,RYN_IP,,,,1132514390,10-02-2024,2.1,-2.1,8546105.0,PCS,Issue to Patient,1.0,1.58003,-1.58003,1733.0,2738.19497
6590020029,MAGNESIUM SULPHATE 50% INJ -5ML,Medicine,Rayan Hospital,RYN_IP,,,,1132516578,10-02-2024,2.1,-2.1,8546103.0,PCS,Issue to Patient,1.0,1.58003,-1.58003,1732.0,2736.61494
6590020029,MAGNESIUM SULPHATE 50% INJ -5ML,Medicine,Rayan Hospital,RYN_IP,,,,1132681847,10-02-2024,2.1,-2.1,8546103.0,PCS,Issue to Patient,1.0,1.58003,-1.58003,1731.0,2735.03491
6590020029,MAGNESIUM SULPHATE 50% INJ -5ML,Medicine,Rayan Hospital,RYN_IP,,,,1132684739,10-02-2024,2.1,-2.1,8546103.0,PCS,Issue to Patient,1.0,1.58003,-1.58003,1730.0,2733.45487
6590020029,MAGNESIUM SULPHATE 50% INJ -5ML,Medicine,Rayan Hospital,RYN_IP,,,,1132754993,11-02-2024,2.1,-2.1,8546103.0,PCS,Issue to Patient,1.0,1.58003,-1.58003,1730.0,2733.45487
6590020029,MAGNESIUM SULPHATE 50% INJ -5ML,Medicine,Rayan Hospital,RYN_IP,,,,1132828682,11-02-2024,2.1,-4.2,8546103.0,PCS,Issue to Patient,2.0,1.58003,-3.16006,1728.0,2730.29481
6590020029,MAGNESIUM SULPHATE 50% INJ -5ML,Medicine,Rayan Hospital,RYN_IP,,,,1132832849,11-02-2024,2.1,-4.2,8546103.0,PCS,Issue to Patient,2.0,1.58003,-3.16006,1726.0,2727.13475
6590020029,MAGNESIUM SULPHATE 50% INJ -5ML,Medicine,Rayan Hospital,RYN_IP,,,,1132956734,11-02-2024,2.1,-2.1,8546105.0,PCS,Issue to Patient,1.0,1.58003,-1.58003,1725.0,2725.55472
6590020029,MAGNESIUM SULPHATE 50% INJ -5ML,Medicine,Rayan Hospital,RYN_IP,,,,1132958867,11-02-2024,2.1,-2.1,8546105.0,PCS,Issue to Patient,1.0,1.58003,-1.58003,1724.0,2723.97468
6590020029,MAGNESIUM SULPHATE 50% INJ -5ML,Medicine,Rayan Hospital,RYN_IP,,,,1132959614,11-02-2024,2.1,-2.1,8546105.0,PCS,Issue to Patient,1.0,1.58003,-1.58003,1723.0,2722.39465
6590020029,MAGNESIUM SULPHATE 50% INJ -5ML,Medicine,Rayan Hospital,RYN_IP,,,,1132962486,11-02-2024,2.1,-2.1,8546105.0,PCS,Issue to Patient,1.0,1.58003,-1.58003,1722.0,2720.81462
6590020029,MAGNESIUM SULPHATE 50% INJ -5ML,Medicine,Rayan Hospital,RYN_IP,,,,1132965212,11-02-2024,2.1,-2.1,8546105.0,PCS,Issue to Patient,1.0,1.58003,-1.58003,1721.0,2719.23459
6590020029,MAGNESIUM SULPHATE 50% INJ -5ML,Medicine,Rayan Hospital,RYN_IP,,,,1132965745,11-02-2024,2.1,-2.1,8546105.0,PCS,Issue to Patient,1.0,1.58003,-1.58003,1720.0,2717.65456
6590020029,MAGNESIUM SULPHATE 50% INJ -5ML,Medicine,Rayan Hospital,RYN_IP,,,,1133074579,11-02-2024,2.1,-2.1,8546103.0,PCS,Issue to Patient,1.0,1.58003,-1.58003,1719.0,2716.07453
6590020029,MAGNESIUM SULPHATE 50% INJ -5ML,Medicine,Rayan Hospital,RYN_IP,,,,1133340791,12-02-2024,2.1,-4.2,8546103.0,PCS,Issue to Patient,2.0,1.58003,-3.16006,1717.0,2712.91446
6590020029,MAGNESIUM SULPHATE 50% INJ -5ML,Medicine,Rayan Hospital,RYN_IP,,,,1133341301,12-02-2024,2.1,-4.2,8546103.0,PCS,Issue to Patient,2.0,1.58003,-3.16006,1715.0,2709.7544
6590020029,MAGNESIUM SULPHATE 50% INJ -5ML,Medicine,Rayan Hospital,RYN_IP,,,,1133342626,12-02-2024,2.1,-4.2,8546103.0,PCS,Issue to Patient,2.0,1.58003,-3.16006,1713.0,2706.59434
6590020029,MAGNESIUM SULPHATE 50% INJ -5ML,Medicine,Rayan Hospital,RYN_IP,,,,1133378236,12-02-2024,2.1,-4.2,8546103.0,PCS,Issue to Patient,2.0,1.58003,-3.16006,1711.0,2703.43427
6590020029,MAGNESIUM SULPHATE 50% INJ -5ML,Medicine,Rayan Hospital,RYN_IP,,,,1133747346,12-02-2024,2.1,-2.1,8546103.0,PCS,Issue to Patient,1.0,1.58003,-1.58003,1710.0,2701.85424
6590020029,MAGNESIUM SULPHATE 50% INJ -5ML,Medicine,Rayan Hospital,RYN_IP,,,,1133770825,12-02-2024,2.1,-2.1,8546103.0,PCS,Issue to Patient,1.0,1.58003,-1.58003,1709.0,2700.27421
6590020029,MAGNESIUM SULPHATE 50% INJ -5ML,Medicine,Rayan Hospital,RYN_IP,,,,1133846491,12-02-2024,2.1,-10.5,8546103.0,PCS,Issue to Patient,5.0,1.58003,-7.90016,1704.0,2692.37405
6590020029,MAGNESIUM SULPHATE 50% INJ -5ML,Medicine,Rayan Hospital,RYN_IP,,,,1133889373,12-02-2024,2.1,-8.4,8546103.0,PCS,Issue to Patient,4.0,1.58003,-6.32013,1700.0,2686.05392
6590020029,MAGNESIUM SULPHATE 50% INJ -5ML,Medicine,Rayan Hospital,RYN_IP,,,,1133914586,13-02-2024,2.1,-4.2,8546103.0,PCS,Issue to Patient,2.0,1.58003,-3.16006,1698.0,2682.89386
6590020029,MAGNESIUM SULPHATE 50% INJ -5ML,Medicine,Rayan Hospital,RYN_IP,,,,1133921996,13-02-2024,2.1,-8.4,8546103.0,PCS,Issue to Patient,4.0,1.58003,-6.32013,1694.0,2676.57373
6590020029,MAGNESIUM SULPHATE 50% INJ -5ML,Medicine,Rayan Hospital,RYN_IP,,,,1133932326,13-02-2024,2.1,-2.1,8546103.0,PCS,Issue to Patient,1.0,1.58003,-1.58003,1693.0,2674.9937
6590020029,MAGNESIUM SULPHATE 50% INJ -5ML,Medicine,Rayan Hospital,RYN_IP,,,,1133936336,13-02-2024,2.1,-4.2,8546103.0,PCS,Issue to Patient,2.0,1.58003,-3.16006,1692.0,2673.41367
6590020029,MAGNESIUM SULPHATE 50% INJ -5ML,Medicine,Rayan Hospital,RYN_IP,,,,1133938049,13-02-2024,2.1,-4.2,8546103.0,PCS,Issue to Patient,2.0,1.58003,-3.16006,1690.0,2670.25361
6590020029,MAGNESIUM SULPHATE 50% INJ -5ML,Medicine,Rayan Hospital,RYN_IP,,,,1133968842,13-02-2024,2.1,-4.2,8546103.0,PCS,Issue to Patient,2.0,1.58003,-3.16006,1688.0,2667.09354
6590020029,MAGNESIUM SULPHATE 50% INJ -5ML,Medicine,Rayan Hospital,RYN_IP,,,,1133971466,13-02-2024,2.1,-4.2,8546103.0,PCS,Issue to Patient,2.0,1.58003,-3.16006,1686.0,2663.93348
6590020029,MAGNESIUM SULPHATE 50% INJ -5ML,Medicine,Rayan Hospital,RYN_IP,,,,1133978835,13-02-2024,2.1,-2.1,8546103.0,PCS,Issue to Patient,1.0,1.58003,-1.58003,1685.0,2662.35345
6590020029,MAGNESIUM SULPHATE 50% INJ -5ML,Medicine,Rayan Hospital,RYN_IP,,,,1133995634,13-02-2024,2.1,-2.1,8546103.0,PCS,Issue to Patient,1.0,1.58003,-1.58003,1684.0,2660.77342
6590020029,MAGNESIUM SULPHATE 50% INJ -5ML,Medicine,Rayan Hospital,RYN_IP,,,,1134158093,13-02-2024,2.1,-8.4,8546103.0,PCS,Issue to Patient,4.0,1.58003,-6.32013,1680.0,2654.45329
6590020029,MAGNESIUM SULPHATE 50% INJ -5ML,Medicine,Rayan Hospital,RYN_IP,,,,1134215813,13-02-2024,2.1,-4.2,8546103.0,PCS,Issue to Patient,2.0,1.58003,-3.16006,1678.0,2651.29323
6590020029,MAGNESIUM SULPHATE 50% INJ -5ML,Medicine,Rayan Hospital,RYN_IP,,,,1134261017,13-02-2024,2.1,-2.1,8546103.0,PCS,Issue to Patient,1.0,1.58003,-1.58003,1677.0,2649.71319
6590020029,MAGNESIUM SULPHATE 50% INJ -5ML,Medicine,Rayan Hospital,RYN_IP,,,,1134320753,13-02-2024,2.1,-4.2,8546105.0,PCS,Issue to Patient,2.0,1.58003,-3.16006,1675.0,2646.55313
6590020029,MAGNESIUM SULPHATE 50% INJ -5ML,Medicine,Rayan Hospital,RYN_IP,,,,1134323129,13-02-2024,2.1,-4.2,8546105.0,PCS,Issue to Patient,2.0,1.58003,-3.16006,1673.0,2643.39307
6590020029,MAGNESIUM SULPHATE 50% INJ -5ML,Medicine,Rayan Hospital,RYN_IP,,,,1134323544,13-02-2024,2.1,-4.2,8546105.0,PCS,Issue to Patient,2.0,1.58003,-3.16006,1671.0,2640.233
6590020029,MAGNESIUM SULPHATE 50% INJ -5ML,Medicine,Rayan Hospital,RYN_IP,,,,1134325123,13-02-2024,2.1,-4.2,8546105.0,PCS,Issue to Patient,2.0,1.58003,-3.16006,1669.0,2637.07294
6590020029,MAGNESIUM SULPHATE 50% INJ -5ML,Medicine,Rayan Hospital,RYN_IP,,,,1134328578,13-02-2024,2.1,-4.2,8546105.0,PCS,Issue to Patient,2.0,1.58003,-3.16006,1667.0,2633.91288
6590020029,MAGNESIUM SULPHATE 50% INJ -5ML,Medicine,Rayan Hospital,RYN_IP,,,,1134330199,13-02-2024,2.1,-4.2,8546105.0,PCS,Issue to Patient,2.0,1.58003,-3.16006,1665.0,2630.75281
6590020029,MAGNESIUM SULPHATE 50% INJ -5ML,Medicine,Rayan Hospital,STAGE,Rayan Hospital Clinics,RAY_ER,17503722,1134348141,13-02-2024,2.1,-6.3,8546104.0,PCS,Int Order Direct Ship,3.0,1.58003,-4.7401,1662.0,2626.01272
6590020029,MAGNESIUM SULPHATE 50% INJ -5ML,Medicine,Rayan Hospital,RYN_IP,,,,1134403053,13-02-2024,2.1,-4.2,8546103.0,PCS,Issue to Patient,2.0,1.58003,-3.16006,1660.0,2622.85265
6590020029,MAGNESIUM SULPHATE 50% INJ -5ML,Medicine,Rayan Hospital,RYN_IP,,,,1134573026,14-02-2024,2.1,-4.2,8546103.0,PCS,Issue to Patient,2.0,1.58003,-3.16006,1658.0,2619.69259
6590020029,MAGNESIUM SULPHATE 50% INJ -5ML,Medicine,Rayan Hospital,RYN_IP,,,,1134597571,14-02-2024,2.1,-2.1,8546103.0,PCS,Issue to Patient,1.0,1.58003,-1.58003,1657.0,2618.11256
6590020029,MAGNESIUM SULPHATE 50% INJ -5ML,Medicine,Rayan Hospital,RYN_IP,,,,1134600471,14-02-2024,2.1,-2.1,8546103.0,PCS,Issue to Patient,1.0,1.58003,-1.58003,1656.0,2616.53253
6590020029,MAGNESIUM SULPHATE 50% INJ -5ML,Medicine,Rayan Hospital,RYN_IP,,,,1134786112,14-02-2024,2.1,-4.2,8546104.0,PCS,Issue to Patient,2.0,1.58003,-3.16006,1654.0,2613.37246
6590020029,MAGNESIUM SULPHATE 50% INJ -5ML,Medicine,Rayan Hospital,RYN_IP,,,,1134796577,14-02-2024,2.1,-2.1,8546103.0,PCS,Issue to Patient,1.0,1.58003,-1.58003,1653.0,2611.79243
6590020029,MAGNESIUM SULPHATE 50% INJ -5ML,Medicine,Rayan Hospital,STAGE,Rayan Hospital Clinics,RAY_ER,17504548,1134803756,14-02-2024,2.1,-10.5,8546104.0,PCS,Int Order Direct Ship,5.0,1.58003,-7.90016,1648.0,2603.89227
6590020029,MAGNESIUM SULPHATE 50% INJ -5ML,Medicine,Rayan Hospital,RYN_IP,,,,1134847642,14-02-2024,2.1,-2.1,8546103.0,PCS,Issue to Patient,1.0,1.58003,-1.58003,1647.0,2602.31224
6590020029,MAGNESIUM SULPHATE 50% INJ -5ML,Medicine,Rayan Hospital,RYN_IP,,,,1134923195,14-02-2024,2.1,-2.1,8546105.0,PCS,Issue to Patient,1.0,1.58003,-1.58003,1647.0,2602.31224
6590020029,MAGNESIUM SULPHATE 50% INJ -5ML,Medicine,Rayan Hospital,RYN_IP,,,,1134923200,14-02-2024,2.1,-2.1,8546105.0,PCS,Issue to Patient,1.0,1.58003,-1.58003,1646.0,2600.73221
6590020029,MAGNESIUM SULPHATE 50% INJ -5ML,Medicine,Rayan Hospital,RYN_IP,,,,1134928347,14-02-2024,2.1,-2.1,8546105.0,PCS,Issue to Patient,1.0,1.58003,-1.58003,1645.0,2599.15218
6590020029,MAGNESIUM SULPHATE 50% INJ -5ML,Medicine,Rayan Hospital,RYN_IP,,,,1134928352,14-02-2024,2.1,-2.1,8546105.0,PCS,Issue to Patient,1.0,1.58003,-1.58003,1644.0,2597.57215
6590020029,MAGNESIUM SULPHATE 50% INJ -5ML,Medicine,Rayan Hospital,RYN_IP,,,,1134928357,14-02-2024,2.1,-2.1,8546105.0,PCS,Issue to Patient,1.0,1.58003,-1.58003,1643.0,2595.99212
6590020029,MAGNESIUM SULPHATE 50% INJ -5ML,Medicine,Rayan Hospital,RYN_IP,,,,1134929218,14-02-2024,2.1,-2.1,8546105.0,PCS,Issue to Patient,1.0,1.58003,-1.58003,1642.0,2594.41208
6590020029,MAGNESIUM SULPHATE 50% INJ -5ML,Medicine,Rayan Hospital,RYN_IP,,,,1134931534,14-02-2024,2.1,-2.1,8546105.0,PCS,Issue to Patient,1.0,1.58003,-1.58003,1641.0,2592.83205
6590020029,MAGNESIUM SULPHATE 50% INJ -5ML,Medicine,Rayan Hospital,RYN_IP,,,,1134986181,14-02-2024,2.1,-8.4,8546103.0,PCS,Issue to Patient,4.0,1.58003,-6.32013,1637.0,2586.51192
6590020029,MAGNESIUM SULPHATE 50% INJ -5ML,Medicine,Rayan Hospital,RYN_IP,,,,1135104761,14-02-2024,2.1,-4.2,8546103.0,PCS,Issue to Patient,2.0,1.58003,-3.16006,1636.0,2584.93189
6590020029,MAGNESIUM SULPHATE 50% INJ -5ML,Medicine,Rayan Hospital,RYN_IP,,,,1135124377,14-02-2024,2.1,-4.2,8546103.0,PCS,Issue to Patient,2.0,1.58003,-3.16006,1634.0,2581.77183
6590020029,MAGNESIUM SULPHATE 50% INJ -5ML,Medicine,Rayan Hospital,RYN_IP,,,,1135194691,15-02-2024,2.1,-8.4,8546103.0,PCS,Issue to Patient,4.0,1.58003,-6.32013,1630.0,2575.4517
6590020029,MAGNESIUM SULPHATE 50% INJ -5ML,Medicine,Rayan Hospital,RYN_IP,,,,1135242151,15-02-2024,2.1,-2.1,8546103.0,PCS,Issue to Patient,1.0,1.58003,-1.58003,1629.0,2573.87167
6590020029,MAGNESIUM SULPHATE 50% INJ -5ML,Medicine,Rayan Hospital,RYN_IP,,,,1135253068,15-02-2024,2.1,-2.1,8546103.0,PCS,Issue to Patient,1.0,1.58003,-1.58003,1628.0,2572.29164
6590020029,MAGNESIUM SULPHATE 50% INJ -5ML,Medicine,Rayan Hospital,RYN_IP,,,,1135368812,15-02-2024,2.1,-2.1,8546103.0,PCS,Issue to Patient,1.0,1.58003,-1.58003,1627.0,2570.71161
6590020029,MAGNESIUM SULPHATE 50% INJ -5ML,Medicine,Rayan Hospital,RYN_IP,,,,1135450257,15-02-2024,2.1,-4.2,8546103.0,PCS,Issue to Patient,2.0,1.58003,-3.16006,1625.0,2567.55154
6590020029,MAGNESIUM SULPHATE 50% INJ -5ML,Medicine,Rayan Hospital,RYN_IP,,,,1135609763,15-02-2024,2.1,-2.1,8546103.0,PCS,Issue to Patient,1.0,1.58003,-1.58003,1624.0,2565.97151
6590020029,MAGNESIUM SULPHATE 50% INJ -5ML,Medicine,Rayan Hospital,RYN_IP,,,,1135661985,16-02-2024,2.1,-4.2,8546103.0,PCS,Issue to Patient,2.0,1.58003,-3.16006,1622.0,2562.81145
6590020029,MAGNESIUM SULPHATE 50% INJ -5ML,Medicine,Rayan Hospital,RYN_IP,,,,1135713535,16-02-2024,2.1,-4.2,8546103.0,PCS,Issue to Patient,2.0,1.58003,-3.16006,1620.0,2559.65139
6590020029,MAGNESIUM SULPHATE 50% INJ -5ML,Medicine,Rayan Hospital,RYN_IP,,,,1135749658,16-02-2024,2.1,-2.1,8546103.0,PCS,Issue to Patient,1.0,1.58003,-1.58003,1619.0,2558.07135
6590020029,MAGNESIUM SULPHATE 50% INJ -5ML,Medicine,Rayan Hospital,RYN_IP,,,,1135753107,16-02-2024,2.1,-8.4,8546103.0,PCS,Issue to Patient,4.0,1.58003,-6.32013,1615.0,2551.75123
6590020029,MAGNESIUM SULPHATE 50% INJ -5ML,Medicine,Rayan Hospital,RYN_IP,,,,1135758919,16-02-2024,2.1,-6.3,8546103.0,PCS,Issue to Patient,3.0,1.58003,-4.7401,1612.0,2547.01113
6590020029,MAGNESIUM SULPHATE 50% INJ -5ML,Medicine,Rayan Hospital,RYN_IP,,,,1135788750,16-02-2024,2.1,-4.2,8546103.0,PCS,Issue to Patient,2.0,1.58003,-3.16006,1610.0,2543.85107
6590020029,MAGNESIUM SULPHATE 50% INJ -5ML,Medicine,Rayan Hospital,RYN_IP,,,,1135793030,16-02-2024,2.1,-2.1,8546103.0,PCS,Issue to Patient,1.0,1.58003,-1.58003,1609.0,2542.27104
6590020029,MAGNESIUM SULPHATE 50% INJ -5ML,Medicine,Rayan Hospital,RYN_IP,,,,1135804920,16-02-2024,2.1,-2.1,8546105.0,PCS,Issue to Patient,1.0,1.58003,-1.58003,1608.0,2540.691
6590020029,MAGNESIUM SULPHATE 50% INJ -5ML,Medicine,Rayan Hospital,RYN_IP,,,,1135806842,16-02-2024,2.1,-2.1,8546103.0,PCS,Issue to Patient,1.0,1.58003,-1.58003,1607.0,2539.11097
6590020029,MAGNESIUM SULPHATE 50% INJ -5ML,Medicine,Rayan Hospital,RYN_IP,,,,1135818918,16-02-2024,2.1,-4.2,8546103.0,PCS,Issue to Patient,2.0,1.58003,-3.16006,1605.0,2535.95091
6590020029,MAGNESIUM SULPHATE 50% INJ -5ML,Medicine,Rayan Hospital,RYN_IP,,,,1135881868,16-02-2024,2.1,-4.2,8546103.0,PCS,Issue to Patient,2.0,1.58003,-3.16006,1603.0,2532.79085
6590020029,MAGNESIUM SULPHATE 50% INJ -5ML,Medicine,Rayan Hospital,RYN_IP,,,,1135886056,16-02-2024,2.1,-2.1,8546103.0,PCS,Issue to Patient,1.0,1.58003,-1.58003,1602.0,2531.21081
6590020029,MAGNESIUM SULPHATE 50% INJ -5ML,Medicine,Rayan Hospital,RYN_IP,,,,1135891072,16-02-2024,2.1,-6.3,8546103.0,PCS,Issue to Patient,3.0,1.58003,-4.7401,1599.0,2526.47072
6590020029,MAGNESIUM SULPHATE 50% INJ -5ML,Medicine,Rayan Hospital,RYN_IP,,,,1135899875,16-02-2024,2.1,-4.2,8546103.0,PCS,Issue to Patient,2.0,1.58003,-3.16006,1597.0,2523.31066
6590020029,MAGNESIUM SULPHATE 50% INJ -5ML,Medicine,Rayan Hospital,RYN_IP,,,,1135901396,16-02-2024,2.1,-4.2,8546103.0,PCS,Issue to Patient,2.0,1.58003,-3.16006,1595.0,2520.15059
6590020029,MAGNESIUM SULPHATE 50% INJ -5ML,Medicine,Rayan Hospital,RYN_IP,,,,1135926377,17-02-2024,2.1,-4.2,8546103.0,PCS,Issue to Patient,2.0,1.58003,-3.16006,1593.0,2516.99053
6590020029,MAGNESIUM SULPHATE 50% INJ -5ML,Medicine,Rayan Hospital,RYN_IP,,,,1135944709,17-02-2024,2.1,-4.2,8546103.0,PCS,Issue to Patient,2.0,1.58003,-3.16006,1591.0,2513.83047
6590020029,MAGNESIUM SULPHATE 50% INJ -5ML,Medicine,Rayan Hospital,RYN_IP,,,,1135946440,17-02-2024,2.1,-4.2,8546103.0,PCS,Issue to Patient,2.0,1.58003,-3.16006,1589.0,2510.6704
6590020029,MAGNESIUM SULPHATE 50% INJ -5ML,Medicine,Rayan Hospital,RYN_IP,,,,1135959075,17-02-2024,2.1,-4.2,8546103.0,PCS,Issue to Patient,2.0,1.58003,-3.16006,1587.0,2507.51034
6590020029,MAGNESIUM SULPHATE 50% INJ -5ML,Medicine,Rayan Hospital,RYN_IP,,,,1135980060,17-02-2024,2.1,-2.1,8546103.0,PCS,Issue to Patient,1.0,1.58003,-1.58003,1586.0,2505.93031
6590020029,MAGNESIUM SULPHATE 50% INJ -5ML,Medicine,Rayan Hospital,RYN_IP,,,,1136038709,17-02-2024,2.1,-8.4,8546103.0,PCS,Issue to Patient,4.0,1.58003,-6.32013,1582.0,2499.61018
6590020029,MAGNESIUM SULPHATE 50% INJ -5ML,Medicine,Rayan Hospital,RYN_IP,,,,1136047223,17-02-2024,2.1,-4.2,8546103.0,PCS,Issue to Patient,2.0,1.58003,-3.16006,1580.0,2496.45012
6590020029,MAGNESIUM SULPHATE 50% INJ -5ML,Medicine,Rayan Hospital,RYN_IP,,,,1136054639,17-02-2024,2.1,-4.2,8546103.0,PCS,Issue to Patient,2.0,1.58003,-3.16006,1578.0,2493.29005
6590020029,MAGNESIUM SULPHATE 50% INJ -5ML,Medicine,Rayan Hospital,RYN_IP,,,,1136113374,17-02-2024,2.1,-4.2,8546103.0,PCS,Issue to Patient,2.0,1.58003,-3.16006,1576.0,2490.12999
6590020029,MAGNESIUM SULPHATE 50% INJ -5ML,Medicine,Rayan Hospital,RYN_IP,,,,1136173183,17-02-2024,2.1,-2.1,8546103.0,PCS,Issue to Patient,1.0,1.58003,-1.58003,1575.0,2488.54996
6590020029,MAGNESIUM SULPHATE 50% INJ -5ML,Medicine,Rayan Hospital,RYN_IP,,,,1136176766,17-02-2024,2.1,-2.1,8546103.0,PCS,Issue to Patient,1.0,1.58003,-1.58003,1574.0,2486.96993
6590020029,MAGNESIUM SULPHATE 50% INJ -5ML,Medicine,Rayan Hospital,RYN_IP,,,,1136176853,17-02-2024,2.1,-2.1,8546103.0,PCS,Issue to Patient,1.0,1.58003,-1.58003,1573.0,2485.38989
6590020029,MAGNESIUM SULPHATE 50% INJ -5ML,Medicine,Rayan Hospital,RYN_IP,,,,1136177970,17-02-2024,2.1,-2.1,8546103.0,PCS,Issue to Patient,1.0,1.58003,-1.58003,1572.0,2483.80986
6590020029,MAGNESIUM SULPHATE 50% INJ -5ML,Medicine,Rayan Hospital,RYN_IP,,,,1136179684,17-02-2024,2.1,-2.1,8546103.0,PCS,Issue to Patient,1.0,1.58003,-1.58003,1571.0,2482.22983
6590020029,MAGNESIUM SULPHATE 50% INJ -5ML,Medicine,Rayan Hospital,RYN_IP,,,,1136179914,17-02-2024,2.1,-2.1,8546103.0,PCS,Issue to Patient,1.0,1.58003,-1.58003,1570.0,2480.6498
6590020029,MAGNESIUM SULPHATE 50% INJ -5ML,Medicine,Rayan Hospital,RYN_IP,,,,1136180541,17-02-2024,2.1,-2.1,8546103.0,PCS,Issue to Patient,1.0,1.58003,-1.58003,1569.0,2479.06977
6590020029,MAGNESIUM SULPHATE 50% INJ -5ML,Medicine,Rayan Hospital,RYN_IP,,,,1136208759,17-02-2024,2.1,-4.2,8546103.0,PCS,Issue to Patient,2.0,1.58003,-3.16006,1567.0,2475.9097
6590020029,MAGNESIUM SULPHATE 50% INJ -5ML,Medicine,Rayan Hospital,RYN_IP,,,,1136506600,18-02-2024,2.1,-2.1,8546103.0,PCS,Issue to Patient,1.0,1.58003,-1.58003,1566.0,2474.32967
6590020029,MAGNESIUM SULPHATE 50% INJ -5ML,Medicine,Rayan Hospital,RYN_IP,,,,1136508958,18-02-2024,2.1,-4.2,8546103.0,PCS,Issue to Patient,2.0,1.58003,-3.16006,1564.0,2471.16961
6590020029,MAGNESIUM SULPHATE 50% INJ -5ML,Medicine,Rayan Hospital,RYN_IP,,,,1136530697,18-02-2024,2.1,-4.2,8546103.0,PCS,Issue to Patient,2.0,1.58003,-3.16006,1562.0,2468.00955
6590020029,MAGNESIUM SULPHATE 50% INJ -5ML,Medicine,Rayan Hospital,RYN_IP,,,,1136530787,18-02-2024,2.1,-2.1,8546103.0,PCS,Issue to Patient,1.0,1.58003,-1.58003,1561.0,2466.42951
6590020029,MAGNESIUM SULPHATE 50% INJ -5ML,Medicine,Rayan Hospital,RYN_IP,,,,1136550332,18-02-2024,2.1,-2.1,8546103.0,PCS,Issue to Patient,1.0,1.58003,-1.58003,1560.0,2464.84948
6590020029,MAGNESIUM SULPHATE 50% INJ -5ML,Medicine,Rayan Hospital,RYN_IP,,,,1136751116,18-02-2024,2.1,-2.1,8546105.0,PCS,Issue to Patient,1.0,1.58003,-1.58003,1559.0,2463.26945
6590020029,MAGNESIUM SULPHATE 50% INJ -5ML,Medicine,Rayan Hospital,RYN_IP,,,,1136751286,18-02-2024,2.1,-2.1,8546105.0,PCS,Issue to Patient,1.0,1.58003,-1.58003,1558.0,2461.68942
6590020029,MAGNESIUM SULPHATE 50% INJ -5ML,Medicine,Rayan Hospital,RYN_IP,,,,1136827414,18-02-2024,2.1,-2.1,8546105.0,PCS,Issue to Patient,1.0,1.58003,-1.58003,1557.0,2460.10939
6590020029,MAGNESIUM SULPHATE 50% INJ -5ML,Medicine,Rayan Hospital,RYN_IP,,,,1136830520,18-02-2024,2.1,-2.1,8546105.0,PCS,Issue to Patient,1.0,1.58003,-1.58003,1556.0,2458.52936
6590020029,MAGNESIUM SULPHATE 50% INJ -5ML,Medicine,Rayan Hospital,RYN_IP,,,,1136830605,18-02-2024,2.1,-2.1,8546105.0,PCS,Issue to Patient,1.0,1.58003,-1.58003,1555.0,2456.94932
6590020029,MAGNESIUM SULPHATE 50% INJ -5ML,Medicine,Rayan Hospital,RYN_IP,,,,1136833825,18-02-2024,2.1,-2.1,8546105.0,PCS,Issue to Patient,1.0,1.58003,-1.58003,1554.0,2455.36929
6590020029,MAGNESIUM SULPHATE 50% INJ -5ML,Medicine,Rayan Hospital,RYN_IP,,,,1136833900,18-02-2024,2.1,-2.1,8546105.0,PCS,Issue to Patient,1.0,1.58003,-1.58003,1553.0,2453.78926
6590020029,MAGNESIUM SULPHATE 50% INJ -5ML,Medicine,Rayan Hospital,RYN_IP,,,,1136834356,18-02-2024,2.1,-2.1,8546105.0,PCS,Issue to Patient,1.0,1.58003,-1.58003,1552.0,2452.20923
6590020029,MAGNESIUM SULPHATE 50% INJ -5ML,Medicine,Rayan Hospital,RYN_IP,,,,1137028404,18-02-2024,2.1,-2.1,8546103.0,PCS,Issue to Patient,1.0,1.58003,-1.58003,1551.0,2450.6292
6590020029,MAGNESIUM SULPHATE 50% INJ -5ML,Medicine,Rayan Hospital,RYN_IP,,,,1137044463,18-02-2024,2.1,-2.1,8546103.0,PCS,Issue to Patient,1.0,1.58003,-1.58003,1550.0,2449.04917
6590020029,MAGNESIUM SULPHATE 50% INJ -5ML,Medicine,Rayan Hospital,RYN_IP,,,,1137068641,19-02-2024,2.1,-4.2,8546103.0,PCS,Issue to Patient,2.0,1.58003,-3.16006,1548.0,2445.8891
6590020029,MAGNESIUM SULPHATE 50% INJ -5ML,Medicine,Rayan Hospital,RYN_IP,,,,1137072583,19-02-2024,2.1,-2.1,8546103.0,PCS,Issue to Patient,1.0,1.58003,-1.58003,1547.0,2444.30907
6590020029,MAGNESIUM SULPHATE 50% INJ -5ML,Medicine,Rayan Hospital,RYN_IP,,,,1137094813,19-02-2024,2.1,-4.2,8546103.0,PCS,Issue to Patient,2.0,1.58003,-3.16006,1545.0,2441.14901
6590020029,MAGNESIUM SULPHATE 50% INJ -5ML,Medicine,Rayan Hospital,RYN_IP,,,,1137106242,19-02-2024,2.1,-2.1,8546103.0,PCS,Issue to Patient,1.0,1.58003,-1.58003,1544.0,2439.56897
6590020029,MAGNESIUM SULPHATE 50% INJ -5ML,Medicine,Rayan Hospital,RYN_IP,,,,1137107788,19-02-2024,2.1,-4.2,8546103.0,PCS,Issue to Patient,2.0,1.58003,-3.16006,1542.0,2436.40891
6590020029,MAGNESIUM SULPHATE 50% INJ -5ML,Medicine,Rayan Hospital,RYN_IP,,,,1137111849,19-02-2024,2.1,-8.4,8546103.0,PCS,Issue to Patient,4.0,1.58003,-6.32013,1538.0,2430.08878
6590020029,MAGNESIUM SULPHATE 50% INJ -5ML,Medicine,Rayan Hospital,RYN_IP,,,,1137114931,19-02-2024,2.1,-2.1,8546103.0,PCS,Issue to Patient,1.0,1.58003,-1.58003,1537.0,2428.50875
6590020029,MAGNESIUM SULPHATE 50% INJ -5ML,Medicine,Rayan Hospital,RYN_IP,,,,1137233137,19-02-2024,2.1,-4.2,8546103.0,PCS,Issue to Patient,2.0,1.58003,-3.16006,1535.0,2425.34869
6590020029,MAGNESIUM SULPHATE 50% INJ -5ML,Medicine,Rayan Hospital,RYN_IP,,,,1137288843,19-02-2024,2.1,-2.1,8546105.0,PCS,Issue to Patient,1.0,1.58003,-1.58003,1534.0,2423.76866
6590020029,MAGNESIUM SULPHATE 50% INJ -5ML,Medicine,Rayan Hospital,RYN_IP,,,,1137291224,19-02-2024,2.1,-2.1,8546105.0,PCS,Issue to Patient,1.0,1.58003,-1.58003,1533.0,2422.18863
6590020029,MAGNESIUM SULPHATE 50% INJ -5ML,Medicine,Rayan Hospital,RYN_IP,,,,1137291274,19-02-2024,2.1,-2.1,8546105.0,PCS,Issue to Patient,1.0,1.58003,-1.58003,1532.0,2420.60859
6590020029,MAGNESIUM SULPHATE 50% INJ -5ML,Medicine,Rayan Hospital,RYN_IP,,,,1137293829,19-02-2024,2.1,-2.1,8546105.0,PCS,Issue to Patient,1.0,1.58003,-1.58003,1531.0,2419.02856
6590020029,MAGNESIUM SULPHATE 50% INJ -5ML,Medicine,Rayan Hospital,RYN_IP,,,,1137293875,19-02-2024,2.1,-2.1,8546105.0,PCS,Issue to Patient,1.0,1.58003,-1.58003,1530.0,2417.44853
6590020029,MAGNESIUM SULPHATE 50% INJ -5ML,Medicine,Rayan Hospital,RYN_IP,,,,1137293930,19-02-2024,2.1,-2.1,8546103.0,PCS,Issue to Patient,1.0,1.58003,-1.58003,1529.0,2415.8685
6590020029,MAGNESIUM SULPHATE 50% INJ -5ML,Medicine,Rayan Hospital,RYN_IP,,,,1137297021,19-02-2024,2.1,-2.1,8546105.0,PCS,Issue to Patient,1.0,1.58003,-1.58003,1528.0,2414.28847
6590020029,MAGNESIUM SULPHATE 50% INJ -5ML,Medicine,Rayan Hospital,RYN_IP,,,,1137297333,19-02-2024,2.1,-2.1,8546105.0,PCS,Issue to Patient,1.0,1.58003,-1.58003,1527.0,2412.70844
6590020029,MAGNESIUM SULPHATE 50% INJ -5ML,Medicine,Rayan Hospital,RYN_IP,,,,1137297939,19-02-2024,2.1,-2.1,8546105.0,PCS,Issue to Patient,1.0,1.58003,-1.58003,1526.0,2411.1284
6590020029,MAGNESIUM SULPHATE 50% INJ -5ML,Medicine,Rayan Hospital,RYN_IP,,,,1137300588,19-02-2024,2.1,-2.1,8546105.0,PCS,Issue to Patient,1.0,1.58003,-1.58003,1525.0,2409.54837
6590020029,MAGNESIUM SULPHATE 50% INJ -5ML,Medicine,Rayan Hospital,RYN_IP,,,,1137300664,19-02-2024,2.1,-2.1,8546105.0,PCS,Issue to Patient,1.0,1.58003,-1.58003,1524.0,2407.96834
6590020029,MAGNESIUM SULPHATE 50% INJ -5ML,Medicine,Rayan Hospital,RYN_IP,,,,1137322202,19-02-2024,2.1,-4.2,8546103.0,PCS,Issue to Patient,2.0,1.58003,-3.16006,1522.0,2404.80828
6590020029,MAGNESIUM SULPHATE 50% INJ -5ML,Medicine,Rayan Hospital,RYN_IP,,,,1137501901,19-02-2024,2.1,-2.1,8546103.0,PCS,Issue to Patient,1.0,1.58003,-1.58003,1521.0,2403.22825
6590020029,MAGNESIUM SULPHATE 50% INJ -5ML,Medicine,Rayan Hospital,STAGE,Rayan Hospital Clinics,RAY_ER,17508560,1137542034,19-02-2024,2.1,-8.4,8546104.0,PCS,Int Order Direct Ship,4.0,1.58003,-6.32013,1517.0,2396.90812
6590020029,MAGNESIUM SULPHATE 50% INJ -5ML,Medicine,Rayan Hospital,RYN_IP,,,,1137686763,20-02-2024,2.1,-2.1,8546103.0,PCS,Issue to Patient,1.0,1.58003,-1.58003,1516.0,2395.32809
6590020029,MAGNESIUM SULPHATE 50% INJ -5ML,Medicine,Rayan Hospital,RYN_IP,,,,1137686773,20-02-2024,2.1,-2.1,8546103.0,PCS,Issue to Patient,1.0,1.58003,-1.58003,1515.0,2393.74806
6590020029,MAGNESIUM SULPHATE 50% INJ -5ML,Medicine,Rayan Hospital,RYN_IP,,,,1137783412,20-02-2024,2.1,-4.2,8546103.0,PCS,Issue to Patient,2.0,1.58003,-3.16006,1513.0,2390.58799
6590020029,MAGNESIUM SULPHATE 50% INJ -5ML,Medicine,Rayan Hospital,RYN_IP,,,,1137835144,20-02-2024,2.1,-2.1,8546103.0,PCS,Issue to Patient,1.0,1.58003,-1.58003,1512.0,2389.00796
6590020029,MAGNESIUM SULPHATE 50% INJ -5ML,Medicine,Rayan Hospital,RYN_IP,,,,1137991457,20-02-2024,2.1,-2.1,8546105.0,PCS,Issue to Patient,1.0,1.58003,-1.58003,1511.0,2387.42793
6590020029,MAGNESIUM SULPHATE 50% INJ -5ML,Medicine,Rayan Hospital,RYN_IP,,,,1137992001,20-02-2024,2.1,-2.1,8546105.0,PCS,Issue to Patient,1.0,1.58003,-1.58003,1510.0,2385.8479
6590020029,MAGNESIUM SULPHATE 50% INJ -5ML,Medicine,Rayan Hospital,RYN_IP,,,,1137993438,20-02-2024,2.1,-2.1,8546105.0,PCS,Issue to Patient,1.0,1.58003,-1.58003,1509.0,2384.26786
6590020029,MAGNESIUM SULPHATE 50% INJ -5ML,Medicine,Rayan Hospital,RYN_IP,,,,1137993716,20-02-2024,2.1,-2.1,8546105.0,PCS,Issue to Patient,1.0,1.58003,-1.58003,1508.0,2382.68783
6590020029,MAGNESIUM SULPHATE 50% INJ -5ML,Medicine,Rayan Hospital,RYN_IP,,,,1137996569,20-02-2024,2.1,-2.1,8546104.0,PCS,Issue to Patient,1.0,1.58003,-1.58003,1507.0,2381.1078
6590020029,MAGNESIUM SULPHATE 50% INJ -5ML,Medicine,Rayan Hospital,RYN_IP,,,,1137996574,20-02-2024,2.1,-2.1,8546105.0,PCS,Issue to Patient,1.0,1.58003,-1.58003,1506.0,2379.52777
6590020029,MAGNESIUM SULPHATE 50% INJ -5ML,Medicine,Rayan Hospital,RYN_IP,,,,1137999304,20-02-2024,2.1,-2.1,8546104.0,PCS,Issue to Patient,1.0,1.58003,-1.58003,1505.0,2377.94774
6590020029,MAGNESIUM SULPHATE 50% INJ -5ML,Medicine,Rayan Hospital,RYN_IP,,,,1137999314,20-02-2024,2.1,-2.1,8546104.0,PCS,Issue to Patient,1.0,1.58003,-1.58003,1504.0,2376.36771
6590020029,MAGNESIUM SULPHATE 50% INJ -5ML,Medicine,Rayan Hospital,RYN_IP,,,,1137999319,20-02-2024,2.1,-2.1,8546104.0,PCS,Issue to Patient,1.0,1.58003,-1.58003,1503.0,2374.78767
6590020029,MAGNESIUM SULPHATE 50% INJ -5ML,Medicine,Rayan Hospital,RYN_IP,,,,1138002559,20-02-2024,2.1,-2.1,8546104.0,PCS,Issue to Patient,1.0,1.58003,-1.58003,1502.0,2373.20764
6590020029,MAGNESIUM SULPHATE 50% INJ -5ML,Medicine,Rayan Hospital,RYN_IP,,,,1138002564,20-02-2024,2.1,-2.1,8546104.0,PCS,Issue to Patient,1.0,1.58003,-1.58003,1501.0,2371.62761
6590020029,MAGNESIUM SULPHATE 50% INJ -5ML,Medicine,Rayan Hospital,RYN_IP,,,,1138002569,20-02-2024,2.1,-2.1,8546104.0,PCS,Issue to Patient,1.0,1.58003,-1.58003,1500.0,2370.04758
6590020029,MAGNESIUM SULPHATE 50% INJ -5ML,Medicine,Rayan Hospital,RYN_IP,,,,1138004386,20-02-2024,2.1,-2.1,8546104.0,PCS,Issue to Patient,1.0,1.58003,-1.58003,1499.0,2368.46755
6590020029,MAGNESIUM SULPHATE 50% INJ -5ML,Medicine,Rayan Hospital,RYN_IP,,,,1138254226,21-02-2024,2.1,-2.1,8546106.0,PCS,Issue to Patient,1.0,1.58003,-1.58003,1498.0,2366.88752
6590020029,MAGNESIUM SULPHATE 50% INJ -5ML,Medicine,Rayan Hospital,RYN_IP,,,,1138368224,21-02-2024,2.1,-2.1,8546103.0,PCS,Issue to Patient,1.0,1.58003,-1.58003,1497.0,2365.30748
6590020029,MAGNESIUM SULPHATE 50% INJ -5ML,Medicine,Rayan Hospital,STAGE,Rayan Hospital Clinics,RAY_ER,17511392,1138461558,21-02-2024,2.1,-10.5,8546104.0,PCS,Int Order Direct Ship,5.0,1.58003,-7.90016,1492.0,2357.40733
6590020029,MAGNESIUM SULPHATE 50% INJ -5ML,Medicine,Rayan Hospital,RYN_IP,,,,1138512064,21-02-2024,2.1,-2.1,8546103.0,PCS,Issue to Patient,1.0,1.58003,-1.58003,1491.0,2355.82729
6590020029,MAGNESIUM SULPHATE 50% INJ -5ML,Medicine,Rayan Hospital,RYN_IP,,,,1138512747,21-02-2024,2.1,-2.1,8546103.0,PCS,Issue to Patient,1.0,1.58003,-1.58003,1490.0,2354.24726
6590020029,MAGNESIUM SULPHATE 50% INJ -5ML,Medicine,Rayan Hospital,RYN_IP,,,,1138515266,21-02-2024,2.1,-2.1,8546103.0,PCS,Issue to Patient,1.0,1.58003,-1.58003,1489.0,2352.66723
6590020029,MAGNESIUM SULPHATE 50% INJ -5ML,Medicine,Rayan Hospital,RYN_IP,,,,1138515291,21-02-2024,2.1,-2.1,8546103.0,PCS,Issue to Patient,1.0,1.58003,-1.58003,1488.0,2351.0872
6590020029,MAGNESIUM SULPHATE 50% INJ -5ML,Medicine,Rayan Hospital,RYN_IP,,,,1138515682,21-02-2024,2.1,-2.1,8546103.0,PCS,Issue to Patient,1.0,1.58003,-1.58003,1487.0,2349.50717
6590020029,MAGNESIUM SULPHATE 50% INJ -5ML,Medicine,Rayan Hospital,RYN_IP,,,,1138529190,21-02-2024,2.1,-4.2,8546103.0,PCS,Issue to Patient,2.0,1.58003,-3.16006,1485.0,2346.3471
6590020029,MAGNESIUM SULPHATE 50% INJ -5ML,Medicine,Rayan Hospital,RYN_IP,,,,1138533178,21-02-2024,2.1,-2.1,8546104.0,PCS,Issue to Patient,1.0,1.58003,-1.58003,1484.0,2344.76707
6590020029,MAGNESIUM SULPHATE 50% INJ -5ML,Medicine,Rayan Hospital,RYN_IP,,,,1138536157,21-02-2024,2.1,-2.1,8546104.0,PCS,Issue to Patient,1.0,1.58003,-1.58003,1483.0,2343.18704
6590020029,MAGNESIUM SULPHATE 50% INJ -5ML,Medicine,Rayan Hospital,RYN_IP,,,,1138536177,21-02-2024,2.1,-2.1,8546104.0,PCS,Issue to Patient,1.0,1.58003,-1.58003,1482.0,2341.60701
6590020029,MAGNESIUM SULPHATE 50% INJ -5ML,Medicine,Rayan Hospital,RYN_IP,,,,1138539465,21-02-2024,2.1,-2.1,8546104.0,PCS,Issue to Patient,1.0,1.58003,-1.58003,1481.0,2340.02698
6590020029,MAGNESIUM SULPHATE 50% INJ -5ML,Medicine,Rayan Hospital,RYN_IP,,,,1138622277,21-02-2024,2.1,-2.1,8546104.0,PCS,Issue to Patient,1.0,1.58003,-1.58003,1480.0,2338.44694
6590020029,MAGNESIUM SULPHATE 50% INJ -5ML,Medicine,Rayan Hospital,RYN_IP,,,,1138625539,21-02-2024,2.1,-2.1,8546104.0,PCS,Issue to Patient,1.0,1.58003,-1.58003,1479.0,2336.86691
6590020029,MAGNESIUM SULPHATE 50% INJ -5ML,Medicine,Rayan Hospital,RYN_IP,,,,1138626261,21-02-2024,2.1,-2.1,8546105.0,PCS,Issue to Patient,1.0,1.58003,-1.58003,1478.0,2335.28688
6590020029,MAGNESIUM SULPHATE 50% INJ -5ML,Medicine,Rayan Hospital,RYN_IP,,,,1138740770,21-02-2024,2.1,-2.1,8546103.0,PCS,Issue to Patient,1.0,1.58003,-1.58003,1477.0,2333.70685
6590020029,MAGNESIUM SULPHATE 50% INJ -5ML,Medicine,Rayan Hospital,RYN_IP,,,,1138871035,22-02-2024,2.1,-4.2,8546103.0,PCS,Issue to Patient,2.0,1.58003,-3.16006,1475.0,2330.54679
6590020029,MAGNESIUM SULPHATE 50% INJ -5ML,Medicine,Rayan Hospital,RYN_IP,,,,1138942080,22-02-2024,2.1,-4.2,8546103.0,PCS,Issue to Patient,2.0,1.58003,-3.16006,1473.0,2327.38672
6590020029,MAGNESIUM SULPHATE 50% INJ -5ML,Medicine,Rayan Hospital,STAGE,Rayan Hospital Clinics,RAY_ER,17511933,1139026483,22-02-2024,2.1,-6.3,8546104.0,PCS,Int Order Direct Ship,3.0,1.58003,-4.7401,1470.0,2322.64663
6590020029,MAGNESIUM SULPHATE 50% INJ -5ML,Medicine,Rayan Hospital,RYN_IP,,,,1139048218,22-02-2024,2.1,-4.2,8546104.0,PCS,Issue to Patient,2.0,1.58003,-3.16006,1468.0,2319.48656
6590020029,MAGNESIUM SULPHATE 50% INJ -5ML,Medicine,Rayan Hospital,RYN_IP,,,,1139117634,22-02-2024,2.1,-2.1,8546103.0,PCS,Issue to Patient,1.0,1.58003,-1.58003,1467.0,2317.90653
6590020029,MAGNESIUM SULPHATE 50% INJ -5ML,Medicine,Rayan Hospital,RYN_IP,,,,1139214959,22-02-2024,2.1,-2.1,8546103.0,PCS,Issue to Patient,1.0,1.58003,-1.58003,1466.0,2316.3265
6590020029,MAGNESIUM SULPHATE 50% INJ -5ML,Medicine,Rayan Hospital,RYN_IP,,,,1139235497,22-02-2024,2.1,-4.2,8546103.0,PCS,Issue to Patient,2.0,1.58003,-3.16006,1464.0,2313.16644
6590020029,MAGNESIUM SULPHATE 50% INJ -5ML,Medicine,Rayan Hospital,RYN_IP,,,,1139274856,23-02-2024,2.1,-4.2,8546103.0,PCS,Issue to Patient,2.0,1.58003,-3.16006,1462.0,2310.00637
6590020029,MAGNESIUM SULPHATE 50% INJ -5ML,Medicine,Rayan Hospital,RYN_IP,,,,1139298724,23-02-2024,2.1,-4.2,8546103.0,PCS,Issue to Patient,2.0,1.58003,-3.16006,1460.0,2306.84631
6590020029,MAGNESIUM SULPHATE 50% INJ -5ML,Medicine,Rayan Hospital,RYN_IP,,,,1139338301,23-02-2024,2.1,-2.1,8546103.0,PCS,Issue to Patient,1.0,1.58003,-1.58003,1459.0,2305.26628
6590020029,MAGNESIUM SULPHATE 50% INJ -5ML,Medicine,Rayan Hospital,RYN_IP,,,,1139355673,23-02-2024,2.1,-4.2,8546104.0,PCS,Issue to Patient,2.0,1.58003,-3.16006,1457.0,2302.10622
6590020029,MAGNESIUM SULPHATE 50% INJ -5ML,Medicine,Rayan Hospital,RYN_IP,,,,1139390769,23-02-2024,2.1,-2.1,8546105.0,PCS,Issue to Patient,1.0,1.58003,-1.58003,1456.0,2300.52618
6590020029,MAGNESIUM SULPHATE 50% INJ -5ML,Medicine,Rayan Hospital,RYN_IP,,,,1139392504,23-02-2024,2.1,-2.1,8546106.0,PCS,Issue to Patient,1.0,1.58003,-1.58003,1455.0,2298.94615
6590020029,MAGNESIUM SULPHATE 50% INJ -5ML,Medicine,Rayan Hospital,RYN_IP,,,,1139394188,23-02-2024,2.1,-2.1,8546105.0,PCS,Issue to Patient,1.0,1.58003,-1.58003,1454.0,2297.36612
6590020029,MAGNESIUM SULPHATE 50% INJ -5ML,Medicine,Rayan Hospital,RYN_IP,,,,1139518430,24-02-2024,2.1,-4.2,8546103.0,PCS,Issue to Patient,2.0,1.58003,-3.16006,1452.0,2294.20606
6590020029,MAGNESIUM SULPHATE 50% INJ -5ML,Medicine,Rayan Hospital,RYN_IP,,,,1139547009,24-02-2024,2.1,-4.2,8546103.0,PCS,Issue to Patient,2.0,1.58003,-3.16006,1450.0,2291.04599
6590020029,MAGNESIUM SULPHATE 50% INJ -5ML,Medicine,Rayan Hospital,RYN_IP,,,,1139671957,24-02-2024,2.1,-2.1,8546103.0,PCS,Issue to Patient,1.0,1.58003,-1.58003,1449.0,2289.46596
6590020029,MAGNESIUM SULPHATE 50% INJ -5ML,Medicine,Rayan Hospital,RYN_IP,,,,1139673821,24-02-2024,2.1,-2.1,8546103.0,PCS,Issue to Patient,1.0,1.58003,-1.58003,1448.0,2287.88593
6590020029,MAGNESIUM SULPHATE 50% INJ -5ML,Medicine,Rayan Hospital,RYN_IP,,,,1139685144,24-02-2024,2.1,-2.1,8546103.0,PCS,Issue to Patient,1.0,1.58003,-1.58003,1447.0,2286.3059
6590020029,MAGNESIUM SULPHATE 50% INJ -5ML,Medicine,Rayan Hospital,RYN_IP,,,,1139701249,24-02-2024,2.1,-2.1,8546103.0,PCS,Issue to Patient,1.0,1.58003,-1.58003,1446.0,2284.72587
6590020029,MAGNESIUM SULPHATE 50% INJ -5ML,Medicine,Rayan Hospital,RYN_IP,,,,1139706298,24-02-2024,2.1,-2.1,8546103.0,PCS,Issue to Patient,1.0,1.58003,-1.58003,1445.0,2283.14583
6590020029,MAGNESIUM SULPHATE 50% INJ -5ML,Medicine,Rayan Hospital,RYN_IP,,,,1139710387,24-02-2024,2.1,-2.1,8546103.0,PCS,Issue to Patient,1.0,1.58003,-1.58003,1444.0,2281.5658
6590020029,MAGNESIUM SULPHATE 50% INJ -5ML,Medicine,Rayan Hospital,RYN_IP,,,,1139713269,24-02-2024,2.1,-2.1,8546103.0,PCS,Issue to Patient,1.0,1.58003,-1.58003,1443.0,2279.98577
6590020029,MAGNESIUM SULPHATE 50% INJ -5ML,Medicine,Rayan Hospital,RYN_IP,,,,1139713353,24-02-2024,2.1,-2.1,8546103.0,PCS,Issue to Patient,1.0,1.58003,-1.58003,1442.0,2278.40574
6590020029,MAGNESIUM SULPHATE 50% INJ -5ML,Medicine,Rayan Hospital,RYN_IP,,,,1140071640,25-02-2024,2.1,-4.2,8546103.0,PCS,Issue to Patient,2.0,1.58003,-3.16006,1440.0,2275.24568
6590020029,MAGNESIUM SULPHATE 50% INJ -5ML,Medicine,Rayan Hospital,RYN_IP,,,,1140071655,25-02-2024,2.1,-4.2,8546103.0,PCS,Issue to Patient,2.0,1.58003,-3.16006,1438.0,2272.08561
6590020029,MAGNESIUM SULPHATE 50% INJ -5ML,Medicine,Rayan Hospital,RYN_IP,,,,1140230707,25-02-2024,2.1,-2.1,8546103.0,PCS,Issue to Patient,1.0,1.58003,-1.58003,1437.0,2270.50558
6590020029,MAGNESIUM SULPHATE 50% INJ -5ML,Medicine,Rayan Hospital,RYN_IP,,,,1140238549,25-02-2024,2.1,-4.2,8546103.0,PCS,Issue to Patient,2.0,1.58003,-3.16006,1435.0,2267.34552
6590020029,MAGNESIUM SULPHATE 50% INJ -5ML,Medicine,Rayan Hospital,RYN_IP,,,,1140251462,25-02-2024,2.1,-2.1,8546103.0,PCS,Issue to Patient,1.0,1.58003,-1.58003,1434.0,2265.76549
6590020029,MAGNESIUM SULPHATE 50% INJ -5ML,Medicine,Rayan Hospital,RYN_IP,,,,1140251597,25-02-2024,2.1,-2.1,8546103.0,PCS,Issue to Patient,1.0,1.58003,-1.58003,1433.0,2264.18545
6590020029,MAGNESIUM SULPHATE 50% INJ -5ML,Medicine,Rayan Hospital,RYN_IP,,,,1140253152,25-02-2024,2.1,-2.1,8546103.0,PCS,Issue to Patient,1.0,1.58003,-1.58003,1432.0,2262.60542
6590020029,MAGNESIUM SULPHATE 50% INJ -5ML,Medicine,Rayan Hospital,RYN_IP,,,,1140254495,25-02-2024,2.1,-2.1,8546103.0,PCS,Issue to Patient,1.0,1.58003,-1.58003,1431.0,2261.02539
6590020029,MAGNESIUM SULPHATE 50% INJ -5ML,Medicine,Rayan Hospital,RYN_IP,,,,1140254908,25-02-2024,2.1,-2.1,8546103.0,PCS,Issue to Patient,1.0,1.58003,-1.58003,1430.0,2259.44536
6590020029,MAGNESIUM SULPHATE 50% INJ -5ML,Medicine,Rayan Hospital,RYN_IP,,,,1140256292,25-02-2024,2.1,-2.1,8546103.0,PCS,Issue to Patient,1.0,1.58003,-1.58003,1429.0,2257.86533
6590020029,MAGNESIUM SULPHATE 50% INJ -5ML,Medicine,Rayan Hospital,RYN_IP,,,,1140256572,25-02-2024,2.1,-2.1,8546103.0,PCS,Issue to Patient,1.0,1.58003,-1.58003,1428.0,2256.2853
6590020029,MAGNESIUM SULPHATE 50% INJ -5ML,Medicine,Rayan Hospital,RYN_IP,,,,1140291395,25-02-2024,2.1,-4.2,8546103.0,PCS,Issue to Patient,2.0,1.58003,-3.16006,1426.0,2253.12523
6590020029,MAGNESIUM SULPHATE 50% INJ -5ML,Medicine,Rayan Hospital,RYN_IP,,,,1140310464,25-02-2024,2.1,-8.4,8546103.0,PCS,Issue to Patient,4.0,1.58003,-6.32013,1422.0,2246.80511
6590020029,MAGNESIUM SULPHATE 50% INJ -5ML,Medicine,Rayan Hospital,RYN_IP,,,,1140517857,25-02-2024,2.1,-4.2,8546103.0,PCS,Issue to Patient,2.0,1.58003,-3.16006,1420.0,2243.64504
6590020029,MAGNESIUM SULPHATE 50% INJ -5ML,Medicine,Rayan Hospital,RYN_IP,,,,1140619780,26-02-2024,2.1,-8.4,8546106.0,PCS,Issue to Patient,4.0,1.58003,-6.32013,1416.0,2237.32491
6590020029,MAGNESIUM SULPHATE 50% INJ -5ML,Medicine,Rayan Hospital,RYN_IP,,,,1140698483,26-02-2024,2.1,-4.2,8546103.0,PCS,Issue to Patient,2.0,1.58003,-3.16006,1414.0,2234.16485
6590020029,MAGNESIUM SULPHATE 50% INJ -5ML,Medicine,Rayan Hospital,RYN_IP,,,,1140780386,26-02-2024,2.1,-2.1,8546103.0,PCS,Issue to Patient,1.0,1.58003,-1.58003,1413.0,2232.58482
6590020029,MAGNESIUM SULPHATE 50% INJ -5ML,Medicine,Rayan Hospital,RYN_IP,,,,1140804376,26-02-2024,2.1,-4.2,8546103.0,PCS,Issue to Patient,2.0,1.58003,-3.16006,1411.0,2229.42476
6590020029,MAGNESIUM SULPHATE 50% INJ -5ML,Medicine,Rayan Hospital,RYN_IP,,,,1140826895,26-02-2024,2.1,-4.2,8546103.0,PCS,Issue to Patient,2.0,1.58003,-3.16006,1409.0,2226.26469
6590020029,MAGNESIUM SULPHATE 50% INJ -5ML,Medicine,Rayan Hospital,RYN_IP,,,,1140913428,26-02-2024,2.1,-2.1,8546103.0,PCS,Issue to Patient,1.0,1.58003,-1.58003,1408.0,2224.68466
6590020029,MAGNESIUM SULPHATE 50% INJ -5ML,Medicine,Rayan Hospital,RYN_IP,,,,1140969929,26-02-2024,2.1,-4.2,8546103.0,PCS,Issue to Patient,2.0,1.58003,-3.16006,1406.0,2221.5246
6590020029,MAGNESIUM SULPHATE 50% INJ -5ML,Medicine,Rayan Hospital,RYN_IP,,,,1140981539,26-02-2024,2.1,-2.1,8546106.0,PCS,Issue to Patient,1.0,1.58003,-1.58003,1405.0,2219.94457
6590020029,MAGNESIUM SULPHATE 50% INJ -5ML,Medicine,Rayan Hospital,RYN_IP,,,,1140981714,26-02-2024,2.1,-2.1,8546106.0,PCS,Issue to Patient,1.0,1.58003,-1.58003,1404.0,2218.36453
6590020029,MAGNESIUM SULPHATE 50% INJ -5ML,Medicine,Rayan Hospital,RYN_IP,,,,1140982268,26-02-2024,2.1,-2.1,8546105.0,PCS,Issue to Patient,1.0,1.58003,-1.58003,1403.0,2216.7845
6590020029,MAGNESIUM SULPHATE 50% INJ -5ML,Medicine,Rayan Hospital,RYN_IP,,,,1140983930,26-02-2024,2.1,-2.1,8546105.0,PCS,Issue to Patient,1.0,1.58003,-1.58003,1402.0,2215.20447
6590020029,MAGNESIUM SULPHATE 50% INJ -5ML,Medicine,Rayan Hospital,RYN_IP,,,,1140984511,26-02-2024,2.1,-2.1,8546105.0,PCS,Issue to Patient,1.0,1.58003,-1.58003,1401.0,2213.62444
6590020029,MAGNESIUM SULPHATE 50% INJ -5ML,Medicine,Rayan Hospital,RYN_IP,,,,1140987501,26-02-2024,2.1,-2.1,8546106.0,PCS,Issue to Patient,1.0,1.58003,-1.58003,1400.0,2212.04441
6590020029,MAGNESIUM SULPHATE 50% INJ -5ML,Medicine,Rayan Hospital,RYN_IP,,,,1140987985,26-02-2024,2.1,-2.1,8546106.0,PCS,Issue to Patient,1.0,1.58003,-1.58003,1399.0,2210.46438
6590020029,MAGNESIUM SULPHATE 50% INJ -5ML,Medicine,Rayan Hospital,RYN_IP,,,,1141150742,26-02-2024,2.1,-4.2,8546103.0,PCS,Issue to Patient,2.0,1.58003,-3.16006,1397.0,2207.30431
6590020029,MAGNESIUM SULPHATE 50% INJ -5ML,Medicine,Rayan Hospital,RYN_IP,,,,1141239811,27-02-2024,2.1,-4.2,8546105.0,PCS,Issue to Patient,2.0,1.58003,-3.16006,1395.0,2204.14425
6590020029,MAGNESIUM SULPHATE 50% INJ -5ML,Medicine,Rayan Hospital,RYN_IP,,,,1141241387,27-02-2024,2.1,-4.2,8546104.0,PCS,Issue to Patient,2.0,1.58003,-3.16006,1393.0,2200.98419
6590020029,MAGNESIUM SULPHATE 50% INJ -5ML,Medicine,Rayan Hospital,RYN_IP,,,,1141246845,27-02-2024,2.1,-4.2,8546104.0,PCS,Issue to Patient,2.0,1.58003,-3.16006,1391.0,2197.82412
6590020029,MAGNESIUM SULPHATE 50% INJ -5ML,Medicine,Rayan Hospital,RYN_IP,,,,1141410248,27-02-2024,2.1,-2.1,8546103.0,PCS,Issue to Patient,1.0,1.58003,-1.58003,1390.0,2196.24409
6590020029,MAGNESIUM SULPHATE 50% INJ -5ML,Medicine,Rayan Hospital,RYN_IP,,,,1141545254,27-02-2024,2.1,-4.2,8546103.0,PCS,Issue to Patient,2.0,1.58003,-3.16006,1388.0,2193.08403
6590020029,MAGNESIUM SULPHATE 50% INJ -5ML,Medicine,Rayan Hospital,RYN_IP,,,,1141745395,27-02-2024,2.1,-4.2,8546103.0,PCS,Issue to Patient,2.0,1.58003,-3.16006,1386.0,2189.92396
6590020029,MAGNESIUM SULPHATE 50% INJ -5ML,Medicine,Rayan Hospital,RYN_IP,,,,1141890539,28-02-2024,2.1,-4.2,8546103.0,PCS,Issue to Patient,2.0,1.58003,-3.16006,1384.0,2186.7639
6590020029,MAGNESIUM SULPHATE 50% INJ -5ML,Medicine,Rayan Hospital,RYN_IP,,,,1142025667,28-02-2024,2.1,-2.1,8546103.0,PCS,Issue to Patient,1.0,1.58003,-1.58003,1383.0,2185.18387
6590020029,MAGNESIUM SULPHATE 50% INJ -5ML,Medicine,Rayan Hospital,RYN_IP,,,,1142028396,28-02-2024,2.1,-2.1,8546103.0,PCS,Issue to Patient,1.0,1.58003,-1.58003,1382.0,2183.60384
6590020029,MAGNESIUM SULPHATE 50% INJ -5ML,Medicine,Rayan Hospital,RYN_IP,,,,1142028661,28-02-2024,2.1,-2.1,8546103.0,PCS,Issue to Patient,1.0,1.58003,-1.58003,1381.0,2182.0238
6590020029,MAGNESIUM SULPHATE 50% INJ -5ML,Medicine,Rayan Hospital,RYN_IP,,,,1142029989,28-02-2024,2.1,-2.1,8546105.0,PCS,Issue to Patient,1.0,1.58003,-1.58003,1380.0,2180.44377
6590020029,MAGNESIUM SULPHATE 50% INJ -5ML,Medicine,Rayan Hospital,STAGE,Rayan Hospital Clinics,RAY_ANSTHA,17515175,1142059239,28-02-2024,2.1,-31.5,8546104.0,PCS,Int Order Direct Ship,15.0,1.58003,-23.70048,1365.0,2156.7433
6590020029,MAGNESIUM SULPHATE 50% INJ -5ML,Medicine,Rayan Hospital,RYN_IP,,,,1142082308,28-02-2024,2.1,-2.1,8546103.0,PCS,Issue to Patient,1.0,1.58003,-1.58003,1364.0,2155.16327
6590020029,MAGNESIUM SULPHATE 50% INJ -5ML,Medicine,Rayan Hospital,RYN_IP,,,,1142325144,28-02-2024,2.1,-4.2,8546103.0,PCS,Issue to Patient,2.0,1.58003,-3.16006,1362.0,2152.0032
6590020029,MAGNESIUM SULPHATE 50% INJ -5ML,Medicine,Rayan Hospital,RYN_IP,,,,1142370653,29-02-2024,2.1,-8.4,8546106.0,PCS,Issue to Patient,4.0,1.58003,-6.32013,1358.0,2145.68308
6590020029,MAGNESIUM SULPHATE 50% INJ -5ML,Medicine,Rayan Hospital,RYN_IP,,,,1142422350,29-02-2024,2.1,-4.2,8546104.0,PCS,Issue to Patient,2.0,1.58003,-3.16006,1356.0,2142.52301
6590020029,MAGNESIUM SULPHATE 50% INJ -5ML,Medicine,Rayan Hospital,RYN_IP,,,,1142435976,29-02-2024,2.1,-16.8,8546103.0,PCS,Issue to Patient,8.0,1.58003,-12.64025,1348.0,2129.88276
6590020029,MAGNESIUM SULPHATE 50% INJ -5ML,Medicine,Rayan Hospital,RYN_IP,,,,1142515940,29-02-2024,2.1,-2.1,8546103.0,PCS,Issue to Patient,1.0,1.58003,-1.58003,1347.0,2128.30273
6590020029,MAGNESIUM SULPHATE 50% INJ -5ML,Medicine,Rayan Hospital,RYN_IP,,,,1142627826,29-02-2024,2.1,-4.2,8546103.0,PCS,Issue to Patient,2.0,1.58003,-3.16006,1345.0,2125.14266
6590020029,MAGNESIUM SULPHATE 50% INJ -5ML,Medicine,Rayan Hospital,RYN_IP,,,,1142694772,29-02-2024,2.1,-2.1,8546104.0,PCS,Issue to Patient,1.0,1.58003,-1.58003,1344.0,2123.56263
6590020029,MAGNESIUM SULPHATE 50% INJ -5ML,Medicine,Rayan Hospital,RYN_IP,,,,1142699980,29-02-2024,2.1,-2.1,8546103.0,PCS,Issue to Patient,1.0,1.58003,-1.58003,1343.0,2121.9826
6590020029,MAGNESIUM SULPHATE 50% INJ -5ML,Medicine,Rayan Hospital,RYN_IP,,,,1142700554,29-02-2024,2.1,-2.1,8546103.0,PCS,Issue to Patient,1.0,1.58003,-1.58003,1342.0,2120.40257
6590020029,MAGNESIUM SULPHATE 50% INJ -5ML,Medicine,Rayan Hospital,RYN_IP,,,,1142833102,29-02-2024,2.1,-4.2,8546103.0,PCS,Issue to Patient,2.0,1.58003,-3.16006,1340.0,2117.2425
6590020029,MAGNESIUM SULPHATE 50% INJ -5ML,Medicine,Rayan Hospital,RYN_IP,,,,1142860216,01-03-2024,2.1,-4.2,8546106.0,PCS,Issue to Patient,2.0,1.58003,-3.16006,1338.0,2114.08244
6590020029,MAGNESIUM SULPHATE 50% INJ -5ML,Medicine,Rayan Hospital,RYN_IP,,,,1142907850,01-03-2024,2.1,-2.1,8546106.0,PCS,Issue to Patient,1.0,1.58003,-1.58003,1337.0,2112.50241
6590020029,MAGNESIUM SULPHATE 50% INJ -5ML,Medicine,Rayan Hospital,RYN_IP,,,,1143009815,01-03-2024,2.1,-6.3,8546103.0,PCS,Issue to Patient,3.0,1.58003,-4.7401,1334.0,2107.76231
6590020029,MAGNESIUM SULPHATE 50% INJ -5ML,Medicine,Rayan Hospital,RYN_IP,,,,1143091792,01-03-2024,2.1,-2.1,8546103.0,PCS,Issue to Patient,1.0,1.58003,-1.58003,1333.0,2106.18228
6590020029,MAGNESIUM SULPHATE 50% INJ -5ML,Medicine,Rayan Hospital,RYN_IP,,,,1143141205,02-03-2024,2.1,-4.2,8546103.0,PCS,Issue to Patient,2.0,1.58003,-3.16006,1331.0,2103.02222
6590020029,MAGNESIUM SULPHATE 50% INJ -5ML,Medicine,Rayan Hospital,RYN_IP,,,,1143209535,02-03-2024,2.1,-2.1,8546103.0,PCS,Issue to Patient,1.0,1.58003,-1.58003,1330.0,2101.44219
6590020029,MAGNESIUM SULPHATE 50% INJ -5ML,Medicine,Rayan Hospital,RYN_IP,,,,1143212892,02-03-2024,2.1,-2.1,8546103.0,PCS,Issue to Patient,1.0,1.58003,-1.58003,1329.0,2099.86216
6590020029,MAGNESIUM SULPHATE 50% INJ -5ML,Medicine,Rayan Hospital,STAGE,Rayan Hospital Clinics,RAY_ER,17517005,1143236025,02-03-2024,2.1,-10.5,8546104.0,PCS,Int Order Direct Ship,5.0,1.58003,-7.90016,1324.0,2091.962
6590020029,MAGNESIUM SULPHATE 50% INJ -5ML,Medicine,Rayan Hospital,RYN_IP,,,,1143290099,02-03-2024,2.1,-4.2,8546103.0,PCS,Issue to Patient,2.0,1.58003,-3.16006,1323.0,2090.38196
6590020029,MAGNESIUM SULPHATE 50% INJ -5ML,Medicine,Rayan Hospital,RYN_IP,,,,1143349670,02-03-2024,2.1,-2.1,8546103.0,PCS,Issue to Patient,1.0,1.58003,-1.58003,1322.0,2088.80193
6590020029,MAGNESIUM SULPHATE 50% INJ -5ML,Medicine,Rayan Hospital,RYN_IP,,,,1143355863,02-03-2024,2.1,-2.1,8546103.0,PCS,Issue to Patient,1.0,1.58003,-1.58003,1321.0,2087.2219
6590020029,MAGNESIUM SULPHATE 50% INJ -5ML,Medicine,Rayan Hospital,RYN_IP,,,,1143362100,02-03-2024,2.1,-2.1,8546106.0,PCS,Issue to Patient,1.0,1.58003,-1.58003,1320.0,2085.64187
6590020029,MAGNESIUM SULPHATE 50% INJ -5ML,Medicine,Rayan Hospital,RYN_IP,,,,1143413020,02-03-2024,2.1,-2.1,8546103.0,PCS,Issue to Patient,1.0,1.58003,-1.58003,1319.0,2084.06184
6590020029,MAGNESIUM SULPHATE 50% INJ -5ML,Medicine,Rayan Hospital,RYN_IP,,,,1143440060,02-03-2024,2.1,-2.1,8546106.0,PCS,Issue to Patient,1.0,1.58003,-1.58003,1318.0,2082.48181
6590020029,MAGNESIUM SULPHATE 50% INJ -5ML,Medicine,Rayan Hospital,RYN_IP,,,,1143443101,02-03-2024,2.1,-2.1,8546106.0,PCS,Issue to Patient,1.0,1.58003,-1.58003,1317.0,2080.90177
6590020029,MAGNESIUM SULPHATE 50% INJ -5ML,Medicine,Rayan Hospital,RYN_IP,,,,1143453420,02-03-2024,2.1,-2.1,8546103.0,PCS,Issue to Patient,1.0,1.58003,-1.58003,1316.0,2079.32174
6590020029,MAGNESIUM SULPHATE 50% INJ -5ML,Medicine,Rayan Hospital,RYN_IP,,,,1143456409,02-03-2024,2.1,-2.1,8546106.0,PCS,Issue to Patient,1.0,1.58003,-1.58003,1315.0,2077.74171
6590020029,MAGNESIUM SULPHATE 50% INJ -5ML,Medicine,Rayan Hospital,RYN_IP,,,,1143583450,02-03-2024,2.1,-4.2,8546103.0,PCS,Issue to Patient,2.0,1.58003,-3.16006,1313.0,2074.58165
6590020029,MAGNESIUM SULPHATE 50% INJ -5ML,Medicine,Rayan Hospital,RYN_IP,,,,1143611046,02-03-2024,2.1,-4.2,8546103.0,PCS,Issue to Patient,2.0,1.58003,-3.16006,1311.0,2071.42158
6590020029,MAGNESIUM SULPHATE 50% INJ -5ML,Medicine,Rayan Hospital,RYN_IP,,,,1143733600,03-03-2024,2.1,-2.1,8546106.0,PCS,Issue to Patient,1.0,1.58003,-1.58003,1310.0,2069.84155
6590020029,MAGNESIUM SULPHATE 50% INJ -5ML,Medicine,Rayan Hospital,RYN_IP,,,,1143744157,03-03-2024,2.1,-2.1,8546103.0,PCS,Issue to Patient,1.0,1.58003,-1.58003,1309.0,2068.26152
6590020029,MAGNESIUM SULPHATE 50% INJ -5ML,Medicine,Rayan Hospital,RYN_IP,,,,1143810949,03-03-2024,2.1,-4.2,8546103.0,PCS,Issue to Patient,2.0,1.58003,-3.16006,1307.0,2065.10146
6590020029,MAGNESIUM SULPHATE 50% INJ -5ML,Medicine,Rayan Hospital,RYN_IP,,,,1143824860,03-03-2024,2.1,-4.2,8546104.0,PCS,Issue to Patient,2.0,1.58003,-3.16006,1305.0,2061.94139
6590020029,MAGNESIUM SULPHATE 50% INJ -5ML,Medicine,Rayan Hospital,RYN_IP,,,,1143968959,03-03-2024,2.1,-2.1,8546103.0,PCS,Issue to Patient,1.0,1.58003,-1.58003,1304.0,2060.36136
6590020029,MAGNESIUM SULPHATE 50% INJ -5ML,Medicine,Rayan Hospital,RYN_IP,,,,1143995449,03-03-2024,2.1,-2.1,8546103.0,PCS,Issue to Patient,1.0,1.58003,-1.58003,1303.0,2058.78133
6590020029,MAGNESIUM SULPHATE 50% INJ -5ML,Medicine,Rayan Hospital,RYN_IP,,,,1143996409,03-03-2024,2.1,-2.1,8546103.0,PCS,Issue to Patient,1.0,1.58003,-1.58003,1302.0,2057.2013
6590020029,MAGNESIUM SULPHATE 50% INJ -5ML,Medicine,Rayan Hospital,RYN_IP,,,,1143998267,03-03-2024,2.1,-2.1,8546103.0,PCS,Issue to Patient,1.0,1.58003,-1.58003,1301.0,2055.62127
6590020029,MAGNESIUM SULPHATE 50% INJ -5ML,Medicine,Rayan Hospital,RYN_IP,,,,1144001266,03-03-2024,2.1,-2.1,8546103.0,PCS,Issue to Patient,1.0,1.58003,-1.58003,1300.0,2054.04124
6590020029,MAGNESIUM SULPHATE 50% INJ -5ML,Medicine,Rayan Hospital,RYN_IP,,,,1144001351,03-03-2024,2.1,-2.1,8546103.0,PCS,Issue to Patient,1.0,1.58003,-1.58003,1299.0,2052.4612
6590020029,MAGNESIUM SULPHATE 50% INJ -5ML,Medicine,Rayan Hospital,RYN_IP,,,,1144003250,03-03-2024,2.1,-2.1,8546103.0,PCS,Issue to Patient,1.0,1.58003,-1.58003,1298.0,2050.88117
6590020029,MAGNESIUM SULPHATE 50% INJ -5ML,Medicine,Rayan Hospital,RYN_IP,,,,1144006895,03-03-2024,2.1,-2.1,8546103.0,PCS,Issue to Patient,1.0,1.58003,-1.58003,1297.0,2049.30114
6590020029,MAGNESIUM SULPHATE 50% INJ -5ML,Medicine,Rayan Hospital,RYN_IP,,,,1144307654,04-03-2024,2.1,-2.1,8546103.0,PCS,Issue to Patient,1.0,1.58003,-1.58003,1296.0,2047.72111
6590020029,MAGNESIUM SULPHATE 50% INJ -5ML,Medicine,Rayan Hospital,RYN_IP,,,,1144344223,04-03-2024,2.1,-2.1,8546103.0,PCS,Issue to Patient,1.0,1.58003,-1.58003,1295.0,2046.14108
6590020029,MAGNESIUM SULPHATE 50% INJ -5ML,Medicine,Rayan Hospital,RYN_IP,,,,1144353323,04-03-2024,2.1,-2.1,8546103.0,PCS,Issue to Patient,1.0,1.58003,-1.58003,1294.0,2044.56105
6590020029,MAGNESIUM SULPHATE 50% INJ -5ML,Medicine,Rayan Hospital,RYN_IP,,,,1144379133,04-03-2024,2.1,-4.2,8546103.0,PCS,Issue to Patient,2.0,1.58003,-3.16006,1292.0,2041.40098
6590020029,MAGNESIUM SULPHATE 50% INJ -5ML,Medicine,Rayan Hospital,RYN_IP,,,,1144410067,04-03-2024,2.1,-2.1,8546103.0,PCS,Issue to Patient,1.0,1.58003,-1.58003,1291.0,2039.82095
6590020029,MAGNESIUM SULPHATE 50% INJ -5ML,Medicine,Rayan Hospital,RYN_IP,,,,1144416522,04-03-2024,2.1,-2.1,8546103.0,PCS,Issue to Patient,1.0,1.58003,-1.58003,1290.0,2038.24092
6590020029,MAGNESIUM SULPHATE 50% INJ -5ML,Medicine,Rayan Hospital,RYN_IP,,,,1144426675,04-03-2024,2.1,-2.1,8546103.0,PCS,Issue to Patient,1.0,1.58003,-1.58003,1289.0,2036.66089
6590020029,MAGNESIUM SULPHATE 50% INJ -5ML,Medicine,Rayan Hospital,RYN_IP,,,,1144552880,04-03-2024,2.1,-2.1,8546103.0,PCS,Issue to Patient,1.0,1.58003,-1.58003,1288.0,2035.08085
6590020029,MAGNESIUM SULPHATE 50% INJ -5ML,Medicine,Rayan Hospital,RYN_IP,,,,1144565701,04-03-2024,2.1,-2.1,8546103.0,PCS,Issue to Patient,1.0,1.58003,-1.58003,1287.0,2033.50082
6590020029,MAGNESIUM SULPHATE 50% INJ -5ML,Medicine,Rayan Hospital,RYN_IP,,,,1144602524,04-03-2024,2.1,-4.2,8546103.0,PCS,Issue to Patient,2.0,1.58003,-3.16006,1286.0,2031.92079
6590020029,MAGNESIUM SULPHATE 50% INJ -5ML,Medicine,Rayan Hospital,RYN_IP,,,,1144603327,04-03-2024,2.1,-4.2,8546103.0,PCS,Issue to Patient,2.0,1.58003,-3.16006,1284.0,2028.76073
6590020029,MAGNESIUM SULPHATE 50% INJ -5ML,Medicine,Rayan Hospital,RYN_IP,,,,1144634741,04-03-2024,2.1,-2.1,8546103.0,PCS,Issue to Patient,1.0,1.58003,-1.58003,1283.0,2027.1807
6590020029,MAGNESIUM SULPHATE 50% INJ -5ML,Medicine,Rayan Hospital,RYN_IP,,,,1144690611,04-03-2024,2.1,-2.1,8546106.0,PCS,Issue to Patient,1.0,1.58003,-1.58003,1282.0,2025.60066
6590020029,MAGNESIUM SULPHATE 50% INJ -5ML,Medicine,Rayan Hospital,RYN_IP,,,,1144693659,04-03-2024,2.1,-2.1,8546106.0,PCS,Issue to Patient,1.0,1.58003,-1.58003,1281.0,2024.02063
6590020029,MAGNESIUM SULPHATE 50% INJ -5ML,Medicine,Rayan Hospital,RYN_IP,,,,1144694398,04-03-2024,2.1,-2.1,8546106.0,PCS,Issue to Patient,1.0,1.58003,-1.58003,1280.0,2022.4406
6590020029,MAGNESIUM SULPHATE 50% INJ -5ML,Medicine,Rayan Hospital,RYN_IP,,,,1144698879,04-03-2024,2.1,-2.1,8546106.0,PCS,Issue to Patient,1.0,1.58003,-1.58003,1279.0,2020.86057
6590020029,MAGNESIUM SULPHATE 50% INJ -5ML,Medicine,Rayan Hospital,RYN_IP,,,,1144698978,04-03-2024,2.1,-2.1,8546106.0,PCS,Issue to Patient,1.0,1.58003,-1.58003,1278.0,2019.28054
6590020029,MAGNESIUM SULPHATE 50% INJ -5ML,Medicine,Rayan Hospital,RYN_IP,,,,1144701760,04-03-2024,2.1,-2.1,8546106.0,PCS,Issue to Patient,1.0,1.58003,-1.58003,1277.0,2017.70051
6590020029,MAGNESIUM SULPHATE 50% INJ -5ML,Medicine,Rayan Hospital,RYN_IP,,,,1144701940,04-03-2024,2.1,-2.1,8546106.0,PCS,Issue to Patient,1.0,1.58003,-1.58003,1276.0,2016.12047
6590020029,MAGNESIUM SULPHATE 50% INJ -5ML,Medicine,Rayan Hospital,RYN_IP,,,,1144708563,04-03-2024,2.1,-2.1,8546106.0,PCS,Issue to Patient,1.0,1.58003,-1.58003,1275.0,2014.54044
6590020029,MAGNESIUM SULPHATE 50% INJ -5ML,Medicine,Rayan Hospital,RYN_IP,,,,1144955011,05-03-2024,2.1,-4.2,8546103.0,PCS,Issue to Patient,2.0,1.58003,-3.16006,1273.0,2011.38038
6590020029,MAGNESIUM SULPHATE 50% INJ -5ML,Medicine,Rayan Hospital,RYN_IP,,,,1144980448,05-03-2024,2.1,-8.4,8546103.0,PCS,Issue to Patient,4.0,1.58003,-6.32013,1269.0,2005.06025
6590020029,MAGNESIUM SULPHATE 50% INJ -5ML,Medicine,Rayan Hospital,RYN_IP,,,,1144999032,05-03-2024,2.1,-2.1,8546103.0,PCS,Issue to Patient,1.0,1.58003,-1.58003,1268.0,2003.48022
6590020029,MAGNESIUM SULPHATE 50% INJ -5ML,Medicine,Rayan Hospital,RYN_IP,,,,1145002627,05-03-2024,2.1,-2.1,8546103.0,PCS,Issue to Patient,1.0,1.58003,-1.58003,1267.0,2001.90019
6590020029,MAGNESIUM SULPHATE 50% INJ -5ML,Medicine,Rayan Hospital,RYN_IP,,,,1145030551,05-03-2024,2.1,-2.1,8546103.0,PCS,Issue to Patient,1.0,1.58003,-1.58003,1266.0,2000.32016
6590020029,MAGNESIUM SULPHATE 50% INJ -5ML,Medicine,Rayan Hospital,RYN_IP,,,,1145032948,05-03-2024,2.1,-2.1,8546103.0,PCS,Issue to Patient,1.0,1.58003,-1.58003,1265.0,1998.74013
6590020029,MAGNESIUM SULPHATE 50% INJ -5ML,Medicine,Rayan Hospital,RYN_IP,,,,1145050668,05-03-2024,2.1,-4.2,8546103.0,PCS,Issue to Patient,2.0,1.58003,-3.16006,1263.0,1995.58006
6590020029,MAGNESIUM SULPHATE 50% INJ -5ML,Medicine,Rayan Hospital,RYN_IP,,,,1145055253,05-03-2024,2.1,-2.1,8546103.0,PCS,Issue to Patient,1.0,1.58003,-1.58003,1262.0,1994.00003
6590020029,MAGNESIUM SULPHATE 50% INJ -5ML,Medicine,Rayan Hospital,RYN_IP,,,,1145089649,05-03-2024,2.1,-8.4,8546103.0,PCS,Issue to Patient,4.0,1.58003,-6.32013,1258.0,1987.6799
6590020029,MAGNESIUM SULPHATE 50% INJ -5ML,Medicine,Rayan Hospital,RYN_IP,,,,1145168205,05-03-2024,2.1,-4.2,8546103.0,PCS,Issue to Patient,2.0,1.58003,-3.16006,1256.0,1984.51984
6590020029,MAGNESIUM SULPHATE 50% INJ -5ML,Medicine,Rayan Hospital,RYN_IP,,,,1145182297,05-03-2024,2.1,-4.2,8546103.0,PCS,Issue to Patient,2.0,1.58003,-3.16006,1254.0,1981.35978
6590020029,MAGNESIUM SULPHATE 50% INJ -5ML,Medicine,Rayan Hospital,RYN_IP,,,,1145253170,05-03-2024,2.1,-2.1,8546106.0,PCS,Issue to Patient,1.0,1.58003,-1.58003,1253.0,1979.77974
6590020029,MAGNESIUM SULPHATE 50% INJ -5ML,Medicine,Rayan Hospital,RYN_IP,,,,1145255515,05-03-2024,2.1,-2.1,8546106.0,PCS,Issue to Patient,1.0,1.58003,-1.58003,1252.0,1978.19971
6590020029,MAGNESIUM SULPHATE 50% INJ -5ML,Medicine,Rayan Hospital,RYN_IP,,,,1145256793,05-03-2024,2.1,-2.1,8546106.0,PCS,Issue to Patient,1.0,1.58003,-1.58003,1251.0,1976.61968
6590020029,MAGNESIUM SULPHATE 50% INJ -5ML,Medicine,Rayan Hospital,RYN_IP,,,,1145257686,05-03-2024,2.1,-2.1,8546106.0,PCS,Issue to Patient,1.0,1.58003,-1.58003,1250.0,1975.03965
6590020029,MAGNESIUM SULPHATE 50% INJ -5ML,Medicine,Rayan Hospital,RYN_IP,,,,1145259468,05-03-2024,2.1,-2.1,8546106.0,PCS,Issue to Patient,1.0,1.58003,-1.58003,1249.0,1973.45962
6590020029,MAGNESIUM SULPHATE 50% INJ -5ML,Medicine,Rayan Hospital,RYN_IP,,,,1145259713,05-03-2024,2.1,-2.1,8546106.0,PCS,Issue to Patient,1.0,1.58003,-1.58003,1248.0,1971.87959
6590020029,MAGNESIUM SULPHATE 50% INJ -5ML,Medicine,Rayan Hospital,RYN_IP,,,,1145263000,05-03-2024,2.1,-2.1,8546106.0,PCS,Issue to Patient,1.0,1.58003,-1.58003,1247.0,1970.29955
6590020029,MAGNESIUM SULPHATE 50% INJ -5ML,Medicine,Rayan Hospital,RYN_IP,,,,1145263366,05-03-2024,2.1,-2.1,8546106.0,PCS,Issue to Patient,1.0,1.58003,-1.58003,1246.0,1968.71952
6590020029,MAGNESIUM SULPHATE 50% INJ -5ML,Medicine,Rayan Hospital,RYN_IP,,,,1145350250,05-03-2024,2.1,-4.2,8546104.0,PCS,Issue to Patient,2.0,1.58003,-3.16006,1244.0,1965.55946
6590020029,MAGNESIUM SULPHATE 50% INJ -5ML,Medicine,Rayan Hospital,RYN_IP,,,,1145435337,05-03-2024,2.1,-8.4,8546103.0,PCS,Issue to Patient,4.0,1.58003,-6.32013,1240.0,1959.23933
6590020029,MAGNESIUM SULPHATE 50% INJ -5ML,Medicine,Rayan Hospital,RYN_IP,,,,1145603608,06-03-2024,2.1,-2.1,8546103.0,PCS,Issue to Patient,1.0,1.58003,-1.58003,1239.0,1957.6593
6590020029,MAGNESIUM SULPHATE 50% INJ -5ML,Medicine,Rayan Hospital,RYN_IP,,,,1145610663,06-03-2024,2.1,-2.1,8546103.0,PCS,Issue to Patient,1.0,1.58003,-1.58003,1238.0,1956.07927
6590020029,MAGNESIUM SULPHATE 50% INJ -5ML,Medicine,Rayan Hospital,RYN_IP,,,,1145612274,06-03-2024,2.1,-4.2,8546103.0,PCS,Issue to Patient,2.0,1.58003,-3.16006,1236.0,1952.91921
6590020029,MAGNESIUM SULPHATE 50% INJ -5ML,Medicine,Rayan Hospital,RYN_IP,,,,1145621642,06-03-2024,2.1,-2.1,8546103.0,PCS,Issue to Patient,1.0,1.58003,-1.58003,1235.0,1951.33917
6590020029,MAGNESIUM SULPHATE 50% INJ -5ML,Medicine,Rayan Hospital,RYN_IP,,,,1145626479,06-03-2024,2.1,-4.2,8546103.0,PCS,Issue to Patient,2.0,1.58003,-3.16006,1233.0,1948.17911
6590020029,MAGNESIUM SULPHATE 50% INJ -5ML,Medicine,Rayan Hospital,RYN_IP,,,,1145640288,06-03-2024,2.1,-2.1,8546103.0,PCS,Issue to Patient,1.0,1.58003,-1.58003,1232.0,1946.59908
6590020029,MAGNESIUM SULPHATE 50% INJ -5ML,Medicine,Rayan Hospital,RYN_IP,,,,1145723145,06-03-2024,2.1,-4.2,8546103.0,PCS,Issue to Patient,2.0,1.58003,-3.16006,1230.0,1943.43901
6590020029,MAGNESIUM SULPHATE 50% INJ -5ML,Medicine,Rayan Hospital,RYN_IP,,,,1145757976,06-03-2024,2.1,-2.1,8546103.0,PCS,Issue to Patient,1.0,1.58003,-1.58003,1229.0,1941.85898
6590020029,MAGNESIUM SULPHATE 50% INJ -5ML,Medicine,Rayan Hospital,RYN_IP,,,,1145815664,06-03-2024,2.1,-4.2,8546103.0,PCS,Issue to Patient,2.0,1.58003,-3.16006,1227.0,1938.69892
6590020029,MAGNESIUM SULPHATE 50% INJ -5ML,Medicine,Rayan Hospital,RYN_IP,,,,1145817725,06-03-2024,2.1,-2.1,8546103.0,PCS,Issue to Patient,1.0,1.58003,-1.58003,1226.0,1937.11889
6590020029,MAGNESIUM SULPHATE 50% INJ -5ML,Medicine,Rayan Hospital,RYN_IP,,,,1145818124,06-03-2024,2.1,-2.1,8546106.0,PCS,Issue to Patient,1.0,1.58003,-1.58003,1225.0,1935.53886
6590020029,MAGNESIUM SULPHATE 50% INJ -5ML,Medicine,Rayan Hospital,RYN_IP,,,,1145819829,06-03-2024,2.1,-2.1,8546106.0,PCS,Issue to Patient,1.0,1.58003,-1.58003,1224.0,1933.95882
6590020029,MAGNESIUM SULPHATE 50% INJ -5ML,Medicine,Rayan Hospital,RYN_IP,,,,1145824094,06-03-2024,2.1,-2.1,8546104.0,PCS,Issue to Patient,1.0,1.58003,-1.58003,1223.0,1932.37879
6590020029,MAGNESIUM SULPHATE 50% INJ -5ML,Medicine,Rayan Hospital,RYN_IP,,,,1145826017,06-03-2024,2.1,-2.1,8546104.0,PCS,Issue to Patient,1.0,1.58003,-1.58003,1222.0,1930.79876
6590020029,MAGNESIUM SULPHATE 50% INJ -5ML,Medicine,Rayan Hospital,RYN_IP,,,,1145877379,06-03-2024,2.1,-2.1,8546104.0,PCS,Issue to Patient,1.0,1.58003,-1.58003,1221.0,1929.21873
6590020029,MAGNESIUM SULPHATE 50% INJ -5ML,Medicine,Rayan Hospital,RYN_IP,,,,1145877389,06-03-2024,2.1,-2.1,8546104.0,PCS,Issue to Patient,1.0,1.58003,-1.58003,1220.0,1927.6387
6590020029,MAGNESIUM SULPHATE 50% INJ -5ML,Medicine,Rayan Hospital,RYN_IP,,,,1145877971,06-03-2024,2.1,-2.1,8546103.0,PCS,Issue to Patient,1.0,1.58003,-1.58003,1219.0,1926.05867
6590020029,MAGNESIUM SULPHATE 50% INJ -5ML,Medicine,Rayan Hospital,RYN_IP,,,,1146153551,06-03-2024,2.1,-2.1,8546103.0,PCS,Issue to Patient,1.0,1.58003,-1.58003,1218.0,1924.47863
6590020029,MAGNESIUM SULPHATE 50% INJ -5ML,Medicine,Rayan Hospital,RYN_IP,,,,1146217650,07-03-2024,2.1,-2.1,8546103.0,PCS,Issue to Patient,1.0,1.58003,-1.58003,1217.0,1922.8986
6590020029,MAGNESIUM SULPHATE 50% INJ -5ML,Medicine,Rayan Hospital,RYN_IP,,,,1146246881,07-03-2024,2.1,-8.4,8546103.0,PCS,Issue to Patient,4.0,1.58003,-6.32013,1213.0,1916.57848
6590020029,MAGNESIUM SULPHATE 50% INJ -5ML,Medicine,Rayan Hospital,RYN_IP,,,,1146295889,07-03-2024,2.1,-2.1,8546103.0,PCS,Issue to Patient,1.0,1.58003,-1.58003,1212.0,1914.99844
6590020029,MAGNESIUM SULPHATE 50% INJ -5ML,Medicine,Rayan Hospital,RYN_IP,,,,1146319713,07-03-2024,2.1,-4.2,8546103.0,PCS,Issue to Patient,2.0,1.58003,-3.16006,1210.0,1911.83838
6590020029,MAGNESIUM SULPHATE 50% INJ -5ML,Medicine,Rayan Hospital,RYN_IP,,,,1146339213,07-03-2024,2.1,-8.4,8546103.0,PCS,Issue to Patient,4.0,1.58003,-6.32013,1206.0,1905.51825
6590020029,MAGNESIUM SULPHATE 50% INJ -5ML,Medicine,Rayan Hospital,RYN_IP,,,,1146349384,07-03-2024,2.1,-2.1,8546103.0,PCS,Issue to Patient,1.0,1.58003,-1.58003,1205.0,1903.93822
6590020029,MAGNESIUM SULPHATE 50% INJ -5ML,Medicine,Rayan Hospital,RYN_IP,,,,1146398834,07-03-2024,2.1,-2.1,8546103.0,PCS,Issue to Patient,1.0,1.58003,-1.58003,1204.0,1902.35819
6590020029,MAGNESIUM SULPHATE 50% INJ -5ML,Medicine,Rayan Hospital,RYN_IP,,,,1146461727,07-03-2024,2.1,-2.1,8546106.0,PCS,Issue to Patient,1.0,1.58003,-1.58003,1203.0,1900.77816
6590020029,MAGNESIUM SULPHATE 50% INJ -5ML,Medicine,Rayan Hospital,RYN_IP,,,,1146464798,07-03-2024,2.1,-2.1,8546106.0,PCS,Issue to Patient,1.0,1.58003,-1.58003,1202.0,1899.19813
6590020029,MAGNESIUM SULPHATE 50% INJ -5ML,Medicine,Rayan Hospital,RYN_IP,,,,1146469629,07-03-2024,2.1,-2.1,8546106.0,PCS,Issue to Patient,1.0,1.58003,-1.58003,1201.0,1897.6181
6590020029,MAGNESIUM SULPHATE 50% INJ -5ML,Medicine,Rayan Hospital,RYN_IP,,,,1146482259,07-03-2024,2.1,-2.1,8546106.0,PCS,Issue to Patient,1.0,1.58003,-1.58003,1200.0,1896.03806
6590020029,MAGNESIUM SULPHATE 50% INJ -5ML,Medicine,Rayan Hospital,RYN_IP,,,,1146488035,07-03-2024,2.1,-2.1,8546106.0,PCS,Issue to Patient,1.0,1.58003,-1.58003,1199.0,1894.45803
6590020029,MAGNESIUM SULPHATE 50% INJ -5ML,Medicine,Rayan Hospital,RYN_IP,,,,1146559375,07-03-2024,2.1,-2.1,8546106.0,PCS,Issue to Patient,1.0,1.58003,-1.58003,1198.0,1892.878
6590020029,MAGNESIUM SULPHATE 50% INJ -5ML,Medicine,Rayan Hospital,RYN_IP,,,,1146562765,07-03-2024,2.1,-2.1,8546106.0,PCS,Issue to Patient,1.0,1.58003,-1.58003,1197.0,1891.29797
6590020029,MAGNESIUM SULPHATE 50% INJ -5ML,Medicine,Rayan Hospital,RYN_IP,,,,1146588412,07-03-2024,2.1,-2.1,8546103.0,PCS,Issue to Patient,1.0,1.58003,-1.58003,1196.0,1889.71794
6590020029,MAGNESIUM SULPHATE 50% INJ -5ML,Medicine,Rayan Hospital,RYN_IP,,,,1146592281,07-03-2024,2.1,-2.1,8546106.0,PCS,Issue to Patient,1.0,1.58003,-1.58003,1195.0,1888.1379
6590020029,MAGNESIUM SULPHATE 50% INJ -5ML,Medicine,Rayan Hospital,RYN_IP,,,,1146595061,07-03-2024,2.1,-2.1,8546106.0,PCS,Issue to Patient,1.0,1.58003,-1.58003,1194.0,1886.55787
6590020029,MAGNESIUM SULPHATE 50% INJ -5ML,Medicine,Rayan Hospital,RYN_IP,,,,1146801006,08-03-2024,2.1,-4.2,8546103.0,PCS,Issue to Patient,2.0,1.58003,-3.16006,1192.0,1883.39781
6590020029,MAGNESIUM SULPHATE 50% INJ -5ML,Medicine,Rayan Hospital,RYN_IP,,,,1146865858,08-03-2024,2.1,-4.2,8546103.0,PCS,Issue to Patient,2.0,1.58003,-3.16006,1190.0,1880.23775
6590020029,MAGNESIUM SULPHATE 50% INJ -5ML,Medicine,Rayan Hospital,RYN_IP,,,,1146869568,08-03-2024,2.1,-4.2,8546103.0,PCS,Issue to Patient,2.0,1.58003,-3.16006,1188.0,1877.07768
6590020029,MAGNESIUM SULPHATE 50% INJ -5ML,Medicine,Rayan Hospital,RYN_IP,,,,1146883277,08-03-2024,2.1,-8.4,8546103.0,PCS,Issue to Patient,4.0,1.58003,-6.32013,1184.0,1870.75756
6590020029,MAGNESIUM SULPHATE 50% INJ -5ML,Medicine,Rayan Hospital,RYN_IP,,,,1146920604,08-03-2024,2.1,-2.1,8546103.0,PCS,Issue to Patient,1.0,1.58003,-1.58003,1185.0,1872.33759
6590020029,MAGNESIUM SULPHATE 50% INJ -5ML,Medicine,Rayan Hospital,RYN_IP,,,,1146920914,08-03-2024,2.1,-2.1,8546103.0,PCS,Issue to Patient,1.0,1.58003,-1.58003,1184.0,1870.75756
6590020029,MAGNESIUM SULPHATE 50% INJ -5ML,Medicine,Rayan Hospital,RYN_IP,,,,1146924239,08-03-2024,2.1,-2.1,8546103.0,PCS,Issue to Patient,1.0,1.58003,-1.58003,1183.0,1869.17752
6590020029,MAGNESIUM SULPHATE 50% INJ -5ML,Medicine,Rayan Hospital,RYN_IP,,,,1146960796,08-03-2024,2.1,-2.1,8546103.0,PCS,Issue to Patient,1.0,1.58003,-1.58003,1182.0,1867.59749
6590020029,MAGNESIUM SULPHATE 50% INJ -5ML,Medicine,Rayan Hospital,RYN_IP,,,,1146962230,08-03-2024,2.1,-4.2,8546103.0,PCS,Issue to Patient,2.0,1.58003,-3.16006,1180.0,1864.43743
6590020029,MAGNESIUM SULPHATE 50% INJ -5ML,Medicine,Rayan Hospital,RYN_IP,,,,1146987502,08-03-2024,2.1,-2.1,8546103.0,PCS,Issue to Patient,1.0,1.58003,-1.58003,1179.0,1862.8574
6590020029,MAGNESIUM SULPHATE 50% INJ -5ML,Medicine,Rayan Hospital,RYN_IP,,,,1146999291,08-03-2024,2.1,-2.1,8546103.0,PCS,Issue to Patient,1.0,1.58003,-1.58003,1178.0,1861.27737
6590020029,MAGNESIUM SULPHATE 50% INJ -5ML,Medicine,Rayan Hospital,RYN_IP,,,,1147004379,08-03-2024,2.1,-4.2,8546103.0,PCS,Issue to Patient,2.0,1.58003,-3.16006,1176.0,1858.1173
6590020029,MAGNESIUM SULPHATE 50% INJ -5ML,Medicine,Rayan Hospital,RYN_IP,,,,1147022857,09-03-2024,2.1,-4.2,8546103.0,PCS,Issue to Patient,2.0,1.58003,-3.16006,1174.0,1854.95724
6590020029,MAGNESIUM SULPHATE 50% INJ -5ML,Medicine,Rayan Hospital,RYN_IP,,,,1147037898,09-03-2024,2.1,-6.3,8546103.0,PCS,Issue to Patient,3.0,1.58003,-4.7401,1171.0,1850.21714
6590020029,MAGNESIUM SULPHATE 50% INJ -5ML,Medicine,Rayan Hospital,RYN_IP,,,,1147041046,09-03-2024,2.1,-2.1,8546103.0,PCS,Issue to Patient,1.0,1.58003,-1.58003,1170.0,1848.63711
6590020029,MAGNESIUM SULPHATE 50% INJ -5ML,Medicine,Rayan Hospital,RYN_IP,,,,1147089515,09-03-2024,2.1,-2.1,8546103.0,PCS,Issue to Patient,1.0,1.58003,-1.58003,1169.0,1847.05708
6590020029,MAGNESIUM SULPHATE 50% INJ -5ML,Medicine,Rayan Hospital,RYN_IP,,,,1147096880,09-03-2024,2.1,-4.2,8546103.0,PCS,Issue to Patient,2.0,1.58003,-3.16006,1167.0,1843.89702
6590020029,MAGNESIUM SULPHATE 50% INJ -5ML,Medicine,Rayan Hospital,RYN_IP,,,,1147106937,09-03-2024,2.1,-2.1,8546103.0,PCS,Issue to Patient,1.0,1.58003,-1.58003,1166.0,1842.31698
6590020029,MAGNESIUM SULPHATE 50% INJ -5ML,Medicine,Rayan Hospital,RYN_IP,,,,1147124978,09-03-2024,2.1,-2.1,8546103.0,PCS,Issue to Patient,1.0,1.58003,-1.58003,1165.0,1840.73695
6590020029,MAGNESIUM SULPHATE 50% INJ -5ML,Medicine,Rayan Hospital,RYN_IP,,,,1147151612,09-03-2024,2.1,-4.2,8546103.0,PCS,Issue to Patient,2.0,1.58003,-3.16006,1163.0,1837.57689
6590020029,MAGNESIUM SULPHATE 50% INJ -5ML,Medicine,Rayan Hospital,RYN_IP,,,,1147165463,09-03-2024,2.1,-4.2,8546103.0,PCS,Issue to Patient,2.0,1.58003,-3.16006,1161.0,1834.41683
6590020029,MAGNESIUM SULPHATE 50% INJ -5ML,Medicine,Rayan Hospital,RYN_IP,,,,1147226059,09-03-2024,2.1,-4.2,8546103.0,PCS,Issue to Patient,2.0,1.58003,-3.16006,1159.0,1831.25676
6590020029,MAGNESIUM SULPHATE 50% INJ -5ML,Medicine,Rayan Hospital,RYN_IP,,,,1147303204,09-03-2024,2.1,-2.1,8546103.0,PCS,Issue to Patient,1.0,1.58003,-1.58003,1160.0,1832.83679
6590020029,MAGNESIUM SULPHATE 50% INJ -5ML,Medicine,Rayan Hospital,RYN_IP,,,,1147312677,09-03-2024,2.1,-2.1,8546106.0,PCS,Issue to Patient,1.0,1.58003,-1.58003,1159.0,1831.25676
6590020029,MAGNESIUM SULPHATE 50% INJ -5ML,Medicine,Rayan Hospital,RYN_IP,,,,1147319360,09-03-2024,2.1,-2.1,8546106.0,PCS,Issue to Patient,1.0,1.58003,-1.58003,1158.0,1829.67673
6590020029,MAGNESIUM SULPHATE 50% INJ -5ML,Medicine,Rayan Hospital,RYN_IP,,,,1147327094,09-03-2024,2.1,-2.1,8546106.0,PCS,Issue to Patient,1.0,1.58003,-1.58003,1157.0,1828.0967
6590020029,MAGNESIUM SULPHATE 50% INJ -5ML,Medicine,Rayan Hospital,RYN_IP,,,,1147330717,09-03-2024,2.1,-2.1,8546106.0,PCS,Issue to Patient,1.0,1.58003,-1.58003,1156.0,1826.51667
6590020029,MAGNESIUM SULPHATE 50% INJ -5ML,Medicine,Rayan Hospital,RYN_IP,,,,1147336555,09-03-2024,2.1,-2.1,8546106.0,PCS,Issue to Patient,1.0,1.58003,-1.58003,1155.0,1824.93664
6590020029,MAGNESIUM SULPHATE 50% INJ -5ML,Medicine,Rayan Hospital,RYN_IP,,,,1147358857,09-03-2024,2.1,-2.1,8546106.0,PCS,Issue to Patient,1.0,1.58003,-1.58003,1154.0,1823.3566
6590020029,MAGNESIUM SULPHATE 50% INJ -5ML,Medicine,Rayan Hospital,RYN_IP,,,,1147359147,09-03-2024,2.1,-2.1,8546106.0,PCS,Issue to Patient,1.0,1.58003,-1.58003,1153.0,1821.77657
6590020029,MAGNESIUM SULPHATE 50% INJ -5ML,Medicine,Rayan Hospital,RYN_IP,,,,1147388323,09-03-2024,2.1,-4.2,8546103.0,PCS,Issue to Patient,2.0,1.58003,-3.16006,1151.0,1818.61651
6590020029,MAGNESIUM SULPHATE 50% INJ -5ML,Medicine,Rayan Hospital,RYN_IP,,,,1147462762,09-03-2024,2.1,-2.1,8546103.0,PCS,Issue to Patient,1.0,1.58003,-1.58003,1150.0,1817.03648
6590020029,MAGNESIUM SULPHATE 50% INJ -5ML,Medicine,Rayan Hospital,RYN_IP,,,,1147600570,09-03-2024,2.1,-2.1,8546103.0,PCS,Issue to Patient,1.0,1.58003,-1.58003,1149.0,1815.45645
6590020029,MAGNESIUM SULPHATE 50% INJ -5ML,Medicine,Rayan Hospital,RYN_IP,,,,1147621344,09-03-2024,2.1,-4.2,8546103.0,PCS,Issue to Patient,2.0,1.58003,-3.16006,1147.0,1812.29638
6590020029,MAGNESIUM SULPHATE 50% INJ -5ML,Medicine,Rayan Hospital,RYN_IP,,,,1147710270,10-03-2024,2.1,-2.1,8546103.0,PCS,Issue to Patient,1.0,1.58003,-1.58003,1146.0,1810.71635
6590020029,MAGNESIUM SULPHATE 50% INJ -5ML,Medicine,Rayan Hospital,RYN_IP,,,,1147767252,10-03-2024,2.1,-4.2,8546103.0,PCS,Issue to Patient,2.0,1.58003,-3.16006,1144.0,1807.55629
6590020029,MAGNESIUM SULPHATE 50% INJ -5ML,Medicine,Rayan Hospital,RYN_IP,,,,1147868423,10-03-2024,2.1,-8.4,8546103.0,PCS,Issue to Patient,4.0,1.58003,-6.32013,1140.0,1801.23616
6590020029,MAGNESIUM SULPHATE 50% INJ -5ML,Medicine,Rayan Hospital,RYN_IP,,,,1147921966,10-03-2024,2.1,-2.1,8546103.0,PCS,Issue to Patient,1.0,1.58003,-1.58003,1139.0,1799.65613
6590020029,MAGNESIUM SULPHATE 50% INJ -5ML,Medicine,Rayan Hospital,RYN_IP,,,,1147922241,10-03-2024,2.1,-2.1,8546103.0,PCS,Issue to Patient,1.0,1.58003,-1.58003,1138.0,1798.0761
6590020029,MAGNESIUM SULPHATE 50% INJ -5ML,Medicine,Rayan Hospital,RYN_IP,,,,1147926268,10-03-2024,2.1,-2.1,8546103.0,PCS,Issue to Patient,1.0,1.58003,-1.58003,1137.0,1796.49607
6590020029,MAGNESIUM SULPHATE 50% INJ -5ML,Medicine,Rayan Hospital,RYN_IP,,,,1147996443,10-03-2024,2.1,-2.1,8546104.0,PCS,Issue to Patient,1.0,1.58003,-1.58003,1136.0,1794.91603
6590020029,MAGNESIUM SULPHATE 50% INJ -5ML,Medicine,Rayan Hospital,RYN_IP,,,,1147999407,10-03-2024,2.1,-2.1,8546104.0,PCS,Issue to Patient,1.0,1.58003,-1.58003,1135.0,1793.336
6590020029,MAGNESIUM SULPHATE 50% INJ -5ML,Medicine,Rayan Hospital,RYN_IP,,,,1148004210,10-03-2024,2.1,-2.1,8546106.0,PCS,Issue to Patient,1.0,1.58003,-1.58003,1134.0,1791.75597
6590020029,MAGNESIUM SULPHATE 50% INJ -5ML,Medicine,Rayan Hospital,RYN_IP,,,,1148004322,10-03-2024,2.1,-2.1,8546103.0,PCS,Issue to Patient,1.0,1.58003,-1.58003,1133.0,1790.17594
6590020029,MAGNESIUM SULPHATE 50% INJ -5ML,Medicine,Rayan Hospital,RYN_IP,,,,1148005124,10-03-2024,2.1,-2.1,8546103.0,PCS,Issue to Patient,1.0,1.58003,-1.58003,1132.0,1788.59591
6590020029,MAGNESIUM SULPHATE 50% INJ -5ML,Medicine,Rayan Hospital,RYN_IP,,,,1148010896,10-03-2024,2.1,-2.1,8546106.0,PCS,Issue to Patient,1.0,1.58003,-1.58003,1131.0,1787.01587
6590020029,MAGNESIUM SULPHATE 50% INJ -5ML,Medicine,Rayan Hospital,RYN_IP,,,,1148061589,10-03-2024,2.1,-4.2,8546103.0,PCS,Issue to Patient,2.0,1.58003,-3.16006,1129.0,1783.85581
6590020029,MAGNESIUM SULPHATE 50% INJ -5ML,Medicine,Rayan Hospital,RYN_IP,,,,1148260618,11-03-2024,2.1,-2.1,8546103.0,PCS,Issue to Patient,1.0,1.58003,-1.58003,1128.0,1782.27578
6590020029,MAGNESIUM SULPHATE 50% INJ -5ML,Medicine,Rayan Hospital,RYN_IP,,,,1148271254,11-03-2024,2.1,-6.3,8546103.0,PCS,Issue to Patient,3.0,1.58003,-4.7401,1125.0,1777.53568
6590020029,MAGNESIUM SULPHATE 50% INJ -5ML,Medicine,Rayan Hospital,RYN_IP,,,,1148279694,11-03-2024,2.1,-2.1,8546103.0,PCS,Issue to Patient,1.0,1.58003,-1.58003,1124.0,1775.95565
6590020029,MAGNESIUM SULPHATE 50% INJ -5ML,Medicine,Rayan Hospital,RYN_IP,,,,1148283307,11-03-2024,2.1,-2.1,8546103.0,PCS,Issue to Patient,1.0,1.58003,-1.58003,1123.0,1774.37562
6590020029,MAGNESIUM SULPHATE 50% INJ -5ML,Medicine,Rayan Hospital,RYN_IP,,,,1148286511,11-03-2024,2.1,-2.1,8546103.0,PCS,Issue to Patient,1.0,1.58003,-1.58003,1122.0,1772.79559
6590020029,MAGNESIUM SULPHATE 50% INJ -5ML,Medicine,Rayan Hospital,RYN_IP,,,,1148294340,11-03-2024,2.1,-2.1,8546103.0,PCS,Issue to Patient,1.0,1.58003,-1.58003,1121.0,1771.21556
6590020029,MAGNESIUM SULPHATE 50% INJ -5ML,Medicine,Rayan Hospital,RYN_IP,,,,1148323422,11-03-2024,2.1,-4.2,8546103.0,PCS,Issue to Patient,2.0,1.58003,-3.16006,1119.0,1768.05549
6590020029,MAGNESIUM SULPHATE 50% INJ -5ML,Medicine,Rayan Hospital,RYN_IP,,,,1148334930,11-03-2024,2.1,-4.2,8546103.0,PCS,Issue to Patient,2.0,1.58003,-3.16006,1117.0,1764.89543
6590020029,MAGNESIUM SULPHATE 50% INJ -5ML,Medicine,Rayan Hospital,RYN_IP,,,,1148349300,11-03-2024,2.1,-4.2,8546103.0,PCS,Issue to Patient,2.0,1.58003,-3.16006,1115.0,1761.73537
6590020029,MAGNESIUM SULPHATE 50% INJ -5ML,Medicine,Rayan Hospital,RYN_IP,,,,1148349310,11-03-2024,2.1,-2.1,8546103.0,PCS,Issue to Patient,1.0,1.58003,-1.58003,1114.0,1760.15534
6590020029,MAGNESIUM SULPHATE 50% INJ -5ML,Medicine,Rayan Hospital,RYN_IP,,,,1148398596,11-03-2024,2.1,-4.2,8546103.0,PCS,Issue to Patient,2.0,1.58003,-3.16006,1112.0,1756.99527
6590020029,MAGNESIUM SULPHATE 50% INJ -5ML,Medicine,Rayan Hospital,RYN_IP,,,,1148451052,11-03-2024,2.1,-2.1,8546103.0,PCS,Issue to Patient,1.0,1.58003,-1.58003,1111.0,1755.41524
6590020029,MAGNESIUM SULPHATE 50% INJ -5ML,Medicine,Rayan Hospital,RYN_IP,,,,1148451307,11-03-2024,2.1,-2.1,8546103.0,PCS,Issue to Patient,1.0,1.58003,-1.58003,1110.0,1753.83521
6590020029,MAGNESIUM SULPHATE 50% INJ -5ML,Medicine,Rayan Hospital,RYN_IP,,,,1148453775,11-03-2024,2.1,-2.1,8546103.0,PCS,Issue to Patient,1.0,1.58003,-1.58003,1109.0,1752.25518
6590020029,MAGNESIUM SULPHATE 50% INJ -5ML,Medicine,Rayan Hospital,RYN_IP,,,,1148457487,11-03-2024,2.1,-2.1,8546103.0,PCS,Issue to Patient,1.0,1.58003,-1.58003,1108.0,1750.67515
6590020029,MAGNESIUM SULPHATE 50% INJ -5ML,Medicine,Rayan Hospital,RYN_IP,,,,1148457682,11-03-2024,2.1,-2.1,8546103.0,PCS,Issue to Patient,1.0,1.58003,-1.58003,1107.0,1749.09511
6590020029,MAGNESIUM SULPHATE 50% INJ -5ML,Medicine,Rayan Hospital,RYN_IP,,,,1148458020,11-03-2024,2.1,-2.1,8546103.0,PCS,Issue to Patient,1.0,1.58003,-1.58003,1106.0,1747.51508
6590020029,MAGNESIUM SULPHATE 50% INJ -5ML,Medicine,Rayan Hospital,RYN_IP,,,,1148460219,11-03-2024,2.1,-2.1,8546103.0,PCS,Issue to Patient,1.0,1.58003,-1.58003,1105.0,1745.93505
6590020029,MAGNESIUM SULPHATE 50% INJ -5ML,Medicine,Rayan Hospital,RYN_IP,,,,1148462872,11-03-2024,2.1,-2.1,8546103.0,PCS,Issue to Patient,1.0,1.58003,-1.58003,1104.0,1744.35502
6590020029,MAGNESIUM SULPHATE 50% INJ -5ML,Medicine,Rayan Hospital,RYN_IP,,,,1148463052,11-03-2024,2.1,-2.1,8546103.0,PCS,Issue to Patient,1.0,1.58003,-1.58003,1103.0,1742.77499
6590020029,MAGNESIUM SULPHATE 50% INJ -5ML,Medicine,Rayan Hospital,RYN_IP,,,,1148472829,11-03-2024,2.1,-2.1,8546103.0,PCS,Issue to Patient,1.0,1.58003,-1.58003,1102.0,1741.19495
6590020029,MAGNESIUM SULPHATE 50% INJ -5ML,Medicine,Rayan Hospital,RYN_IP,,,,1148472932,11-03-2024,2.1,-2.1,8546103.0,PCS,Issue to Patient,1.0,1.58003,-1.58003,1101.0,1739.61492
6590020029,MAGNESIUM SULPHATE 50% INJ -5ML,Medicine,Rayan Hospital,RYN_IP,,,,1148495952,11-03-2024,2.1,-4.2,8546103.0,PCS,Issue to Patient,2.0,1.58003,-3.16006,1099.0,1736.45486
6590020029,MAGNESIUM SULPHATE 50% INJ -5ML,Medicine,Rayan Hospital,RYN_IP,,,,1148498235,11-03-2024,2.1,-2.1,8546103.0,PCS,Issue to Patient,1.0,1.58003,-1.58003,1098.0,1734.87483
6590020029,MAGNESIUM SULPHATE 50% INJ -5ML,Medicine,Rayan Hospital,RYN_IP,,,,1148577988,11-03-2024,2.1,-2.1,8546103.0,PCS,Issue to Patient,1.0,1.58003,-1.58003,1097.0,1733.2948
6590020029,MAGNESIUM SULPHATE 50% INJ -5ML,Medicine,Rayan Hospital,RYN_IP,,,,1148714909,12-03-2024,2.1,-2.1,8546103.0,PCS,Issue to Patient,1.0,1.58003,-1.58003,1096.0,1731.71476
6590020029,MAGNESIUM SULPHATE 50% INJ -5ML,Medicine,Rayan Hospital,STAGE,Rayan Hospital Clinics,RAY_ER,17523378,1148798880,12-03-2024,2.1,-8.4,8546104.0,PCS,Int Order Direct Ship,4.0,1.58003,-6.32013,1092.0,1725.39464
6590020029,MAGNESIUM SULPHATE 50% INJ -5ML,Medicine,Rayan Hospital,STAGE,Rayan Hospital Clinics,RAY_ER,17523570,1148799301,12-03-2024,2.1,-2.1,8546100.0,PCS,Int Order Direct Ship,1.0,1.58003,-1.58003,1091.0,1723.81461
6590020029,MAGNESIUM SULPHATE 50% INJ -5ML,Medicine,Rayan Hospital,RYN_IP,,,,1148799847,12-03-2024,2.1,-2.1,8546103.0,PCS,Issue to Patient,1.0,1.58003,-1.58003,1090.0,1722.23457
6590020029,MAGNESIUM SULPHATE 50% INJ -5ML,Medicine,Rayan Hospital,RYN_IP,,,,1148804669,12-03-2024,2.1,-4.2,8546103.0,PCS,Issue to Patient,2.0,1.58003,-3.16006,1088.0,1719.07451
6590020029,MAGNESIUM SULPHATE 50% INJ -5ML,Medicine,Rayan Hospital,STAGE,Rayan Hospital Clinics,RAY_ER,17524244,1148804673,12-03-2024,2.1,-10.5,854683.0,PCS,Int Order Direct Ship,5.0,1.58003,-7.90016,1083.0,1711.17435
6590020029,MAGNESIUM SULPHATE 50% INJ -5ML,Medicine,Rayan Hospital,RYN_IP,,,,1148814095,12-03-2024,2.1,-4.2,8546103.0,PCS,Issue to Patient,2.0,1.58003,-3.16006,1081.0,1708.01429
6590020029,MAGNESIUM SULPHATE 50% INJ -5ML,Medicine,Rayan Hospital,RYN_IP,,,,1148907867,12-03-2024,2.1,-2.1,8546103.0,PCS,Issue to Patient,1.0,1.58003,-1.58003,1080.0,1706.43426
6590020029,MAGNESIUM SULPHATE 50% INJ -5ML,Medicine,Rayan Hospital,RYN_IP,,,,1148911375,12-03-2024,2.1,-2.1,8546103.0,PCS,Issue to Patient,1.0,1.58003,-1.58003,1079.0,1704.85423
6590020029,MAGNESIUM SULPHATE 50% INJ -5ML,Medicine,Rayan Hospital,RYN_IP,,,,1148911385,12-03-2024,2.1,-2.1,8546103.0,PCS,Issue to Patient,1.0,1.58003,-1.58003,1078.0,1703.27419
6590020029,MAGNESIUM SULPHATE 50% INJ -5ML,Medicine,Rayan Hospital,RYN_IP,,,,1148954451,12-03-2024,2.1,-4.2,8546103.0,PCS,Issue to Patient,2.0,1.58003,-3.16006,1076.0,1700.11413
6590020029,MAGNESIUM SULPHATE 50% INJ -5ML,Medicine,Rayan Hospital,RYN_IP,,,,1148967542,12-03-2024,2.1,-2.1,8546103.0,PCS,Issue to Patient,1.0,1.58003,-1.58003,1075.0,1698.5341
6590020029,MAGNESIUM SULPHATE 50% INJ -5ML,Medicine,Rayan Hospital,RYN_IP,,,,1148984277,12-03-2024,2.1,-2.1,8546103.0,PCS,Issue to Patient,1.0,1.58003,-1.58003,1074.0,1696.95407
6590020029,MAGNESIUM SULPHATE 50% INJ -5ML,Medicine,Rayan Hospital,RYN_IP,,,,1148986996,12-03-2024,2.1,-2.1,8546103.0,PCS,Issue to Patient,1.0,1.58003,-1.58003,1073.0,1695.37404
6590020029,MAGNESIUM SULPHATE 50% INJ -5ML,Medicine,Rayan Hospital,RYN_IP,,,,1148992178,12-03-2024,2.1,-2.1,8546103.0,PCS,Issue to Patient,1.0,1.58003,-1.58003,1072.0,1693.794
6590020029,MAGNESIUM SULPHATE 50% INJ -5ML,Medicine,Rayan Hospital,RYN_IP,,,,1148992201,12-03-2024,2.1,-4.2,8546103.0,PCS,Issue to Patient,2.0,1.58003,-3.16006,1070.0,1690.63394
6590020029,MAGNESIUM SULPHATE 50% INJ -5ML,Medicine,Rayan Hospital,RYN_IP,,,,1148996854,12-03-2024,2.1,-2.1,8546103.0,PCS,Issue to Patient,1.0,1.58003,-1.58003,1069.0,1689.05391
6590020029,MAGNESIUM SULPHATE 50% INJ -5ML,Medicine,Rayan Hospital,RYN_IP,,,,1148998814,12-03-2024,2.1,-2.1,8546103.0,PCS,Issue to Patient,1.0,1.58003,-1.58003,1068.0,1687.47388
6590020029,MAGNESIUM SULPHATE 50% INJ -5ML,Medicine,Rayan Hospital,RYN_IP,,,,1148999315,12-03-2024,2.1,-2.1,8546103.0,PCS,Issue to Patient,1.0,1.58003,-1.58003,1067.0,1685.89384
6590020029,MAGNESIUM SULPHATE 50% INJ -5ML,Medicine,Rayan Hospital,RYN_IP,,,,1149081887,12-03-2024,2.1,-2.1,8546103.0,PCS,Issue to Patient,1.0,1.58003,-1.58003,1066.0,1684.31381
6590020029,MAGNESIUM SULPHATE 50% INJ -5ML,Medicine,Rayan Hospital,RYN_IP,,,,1149116299,12-03-2024,2.1,-2.1,8546103.0,PCS,Issue to Patient,1.0,1.58003,-1.58003,1065.0,1682.73378
6590020029,MAGNESIUM SULPHATE 50% INJ -5ML,Medicine,Rayan Hospital,RYN_IP,,,,1149303125,13-03-2024,2.1,-2.1,8546103.0,PCS,Issue to Patient,1.0,1.58003,-1.58003,1064.0,1681.15375
6590020029,MAGNESIUM SULPHATE 50% INJ -5ML,Medicine,Rayan Hospital,RYN_IP,,,,1149303748,13-03-2024,2.1,-2.1,8546103.0,PCS,Issue to Patient,1.0,1.58003,-1.58003,1063.0,1679.57372
6590020029,MAGNESIUM SULPHATE 50% INJ -5ML,Medicine,Rayan Hospital,RYN_IP,,,,1149446713,13-03-2024,2.1,-2.1,8546103.0,PCS,Issue to Patient,1.0,1.58003,-1.58003,1062.0,1677.99369
6590020029,MAGNESIUM SULPHATE 50% INJ -5ML,Medicine,Rayan Hospital,RYN_IP,,,,1149461478,13-03-2024,2.1,-2.1,8546106.0,PCS,Issue to Patient,1.0,1.58003,-1.58003,1061.0,1676.41365
6590020029,MAGNESIUM SULPHATE 50% INJ -5ML,Medicine,Rayan Hospital,RYN_IP,,,,1149462748,13-03-2024,2.1,-2.1,8546106.0,PCS,Issue to Patient,1.0,1.58003,-1.58003,1060.0,1674.83362
6590020029,MAGNESIUM SULPHATE 50% INJ -5ML,Medicine,Rayan Hospital,RYN_IP,,,,1149464804,13-03-2024,2.1,-2.1,8546106.0,PCS,Issue to Patient,1.0,1.58003,-1.58003,1059.0,1673.25359
6590020029,MAGNESIUM SULPHATE 50% INJ -5ML,Medicine,Rayan Hospital,RYN_IP,,,,1149464814,13-03-2024,2.1,-2.1,8546106.0,PCS,Issue to Patient,1.0,1.58003,-1.58003,1058.0,1671.67356
6590020029,MAGNESIUM SULPHATE 50% INJ -5ML,Medicine,Rayan Hospital,RYN_IP,,,,1149467716,13-03-2024,2.1,-2.1,8546106.0,PCS,Issue to Patient,1.0,1.58003,-1.58003,1057.0,1670.09353
6590020029,MAGNESIUM SULPHATE 50% INJ -5ML,Medicine,Rayan Hospital,RYN_IP,,,,1149470409,13-03-2024,2.1,-2.1,8546106.0,PCS,Issue to Patient,1.0,1.58003,-1.58003,1056.0,1668.5135
6590020029,MAGNESIUM SULPHATE 50% INJ -5ML,Medicine,Rayan Hospital,RYN_IP,,,,1149470604,13-03-2024,2.1,-2.1,8546106.0,PCS,Issue to Patient,1.0,1.58003,-1.58003,1055.0,1666.93346
6590020029,MAGNESIUM SULPHATE 50% INJ -5ML,Medicine,Rayan Hospital,RYN_IP,,,,1149472093,13-03-2024,2.1,-2.1,8546106.0,PCS,Issue to Patient,1.0,1.58003,-1.58003,1054.0,1665.35343
6590020029,MAGNESIUM SULPHATE 50% INJ -5ML,Medicine,Rayan Hospital,RYN_IP,,,,1149472108,13-03-2024,2.1,-2.1,8546106.0,PCS,Issue to Patient,1.0,1.58003,-1.58003,1053.0,1663.7734
6590020029,MAGNESIUM SULPHATE 50% INJ -5ML,Medicine,Rayan Hospital,RYN_IP,,,,1149483347,13-03-2024,2.1,-2.1,8546106.0,PCS,Issue to Patient,1.0,1.58003,-1.58003,1052.0,1662.19337
6590020029,MAGNESIUM SULPHATE 50% INJ -5ML,Medicine,Rayan Hospital,RYN_IP,,,,1149485103,13-03-2024,2.1,-2.1,8546104.0,PCS,Issue to Patient,1.0,1.58003,-1.58003,1051.0,1660.61334
6590020029,MAGNESIUM SULPHATE 50% INJ -5ML,Medicine,Rayan Hospital,RYN_IP,,,,1149548085,13-03-2024,2.1,-4.2,8546103.0,PCS,Issue to Patient,2.0,1.58003,-3.16006,1049.0,1657.45327
6590020029,MAGNESIUM SULPHATE 50% INJ -5ML,Medicine,Rayan Hospital,RYN_IP,,,,1149583269,13-03-2024,2.1,-2.1,8546106.0,PCS,Issue to Patient,1.0,1.58003,-1.58003,1048.0,1655.87324
6590020029,MAGNESIUM SULPHATE 50% INJ -5ML,Medicine,Rayan Hospital,RYN_IP,,,,1149774788,14-03-2024,2.1,-2.1,8546103.0,PCS,Issue to Patient,1.0,1.58003,-1.58003,1047.0,1654.29321
6590020029,MAGNESIUM SULPHATE 50% INJ -5ML,Medicine,Rayan Hospital,RYN_IP,,,,1149803043,14-03-2024,2.1,-8.4,8546103.0,PCS,Issue to Patient,4.0,1.58003,-6.32013,1043.0,1647.97308
6590020029,MAGNESIUM SULPHATE 50% INJ -5ML,Medicine,Rayan Hospital,RYN_IP,,,,1149807725,14-03-2024,2.1,-4.2,8546103.0,PCS,Issue to Patient,2.0,1.58003,-3.16006,1041.0,1644.81302
6590020029,MAGNESIUM SULPHATE 50% INJ -5ML,Medicine,Rayan Hospital,RYN_IP,,,,1149819956,14-03-2024,2.1,-2.1,8546103.0,PCS,Issue to Patient,1.0,1.58003,-1.58003,1040.0,1643.23299
6590020029,MAGNESIUM SULPHATE 50% INJ -5ML,Medicine,Rayan Hospital,RYN_IP,,,,1149828413,14-03-2024,2.1,-33.6,8546103.0,PCS,Issue to Patient,16.0,1.58003,-25.28051,1024.0,1617.95248
6590020029,MAGNESIUM SULPHATE 50% INJ -5ML,Medicine,Rayan Hospital,RYN_IP,,,,1149845373,14-03-2024,2.1,-2.1,8546103.0,PCS,Issue to Patient,1.0,1.58003,-1.58003,1023.0,1616.37245
6590020029,MAGNESIUM SULPHATE 50% INJ -5ML,Medicine,Rayan Hospital,RYN_IP,,,,1149957600,14-03-2024,2.1,-2.1,8546104.0,PCS,Issue to Patient,1.0,1.58003,-1.58003,1022.0,1614.79242
6590020029,MAGNESIUM SULPHATE 50% INJ -5ML,Medicine,Rayan Hospital,RYN_IP,,,,1149958139,14-03-2024,2.1,-2.1,8546104.0,PCS,Issue to Patient,1.0,1.58003,-1.58003,1021.0,1613.21239
6590020029,MAGNESIUM SULPHATE 50% INJ -5ML,Medicine,Rayan Hospital,STAGE,Rayan Hospital Clinics,RAY_OR,17526325,1149969856,14-03-2024,2.1,-8.4,8546104.0,PCS,Int Order Direct Ship,4.0,1.58003,-6.32013,1017.0,1606.89226
6590020029,MAGNESIUM SULPHATE 50% INJ -5ML,Medicine,Rayan Hospital,RYN_IP,,,,1149979709,14-03-2024,2.1,-4.2,8546103.0,PCS,Issue to Patient,2.0,1.58003,-3.16006,1015.0,1603.7322
6590020029,MAGNESIUM SULPHATE 50% INJ -5ML,Medicine,Rayan Hospital,RYN_IP,,,,1149997982,14-03-2024,2.1,-4.2,8546103.0,PCS,Issue to Patient,2.0,1.58003,-3.16006,1013.0,1600.57213
6590020029,MAGNESIUM SULPHATE 50% INJ -5ML,Medicine,Rayan Hospital,RYN_IP,,,,1150065143,14-03-2024,2.1,-6.3,8546103.0,PCS,Issue to Patient,3.0,1.58003,-4.7401,1012.0,1598.9921
6590020029,MAGNESIUM SULPHATE 50% INJ -5ML,Medicine,Rayan Hospital,RYN_IP,,,,1150164664,14-03-2024,2.1,-2.1,8546103.0,PCS,Issue to Patient,1.0,1.58003,-1.58003,1011.0,1597.41207
6590020029,MAGNESIUM SULPHATE 50% INJ -5ML,Medicine,Rayan Hospital,RYN_IP,,,,1150171785,14-03-2024,2.1,-2.1,8546103.0,PCS,Issue to Patient,1.0,1.58003,-1.58003,1010.0,1595.83204
6590020029,MAGNESIUM SULPHATE 50% INJ -5ML,Medicine,Rayan Hospital,RYN_IP,,,,1150295250,15-03-2024,2.1,-6.3,8546103.0,PCS,Issue to Patient,3.0,1.58003,-4.7401,1007.0,1591.09194
6590020029,MAGNESIUM SULPHATE 50% INJ -5ML,Medicine,Rayan Hospital,RYN_IP,,,,1150302399,15-03-2024,2.1,-4.2,8546103.0,PCS,Issue to Patient,2.0,1.58003,-3.16006,1005.0,1587.93188
6590020029,MAGNESIUM SULPHATE 50% INJ -5ML,Medicine,Rayan Hospital,RYN_IP,,,,1150306956,15-03-2024,2.1,-4.2,8546103.0,PCS,Issue to Patient,2.0,1.58003,-3.16006,1003.0,1584.77181
6590020029,MAGNESIUM SULPHATE 50% INJ -5ML,Medicine,Rayan Hospital,RYN_IP,,,,1150309393,15-03-2024,2.1,-4.2,8546103.0,PCS,Issue to Patient,2.0,1.58003,-3.16006,1001.0,1581.61175
6590020029,MAGNESIUM SULPHATE 50% INJ -5ML,Medicine,Rayan Hospital,RYN_IP,,,,1150313629,15-03-2024,2.1,-2.1,8546103.0,PCS,Issue to Patient,1.0,1.58003,-1.58003,1000.0,1580.03172
6590020029,MAGNESIUM SULPHATE 50% INJ -5ML,Medicine,Rayan Hospital,RYN_IP,,,,1150321182,15-03-2024,2.1,-2.1,8546103.0,PCS,Issue to Patient,1.0,1.58003,-1.58003,999.0,1578.45169
6590020029,MAGNESIUM SULPHATE 50% INJ -5ML,Medicine,Rayan Hospital,RYN_IP,,,,1150342049,15-03-2024,2.1,-4.2,8546103.0,PCS,Issue to Patient,2.0,1.58003,-3.16006,997.0,1575.29162
6590020029,MAGNESIUM SULPHATE 50% INJ -5ML,Medicine,Rayan Hospital,RYN_IP,,,,1150342124,15-03-2024,2.1,-2.1,8546103.0,PCS,Issue to Patient,1.0,1.58003,-1.58003,996.0,1573.71159
6590020029,MAGNESIUM SULPHATE 50% INJ -5ML,Medicine,Rayan Hospital,RYN_IP,,,,1150347551,15-03-2024,2.1,-2.1,8546103.0,PCS,Issue to Patient,1.0,1.58003,-1.58003,995.0,1572.13156
6590020029,MAGNESIUM SULPHATE 50% INJ -5ML,Medicine,Rayan Hospital,RYN_IP,,,,1150361195,15-03-2024,2.1,-2.1,8546103.0,PCS,Issue to Patient,1.0,1.58003,-1.58003,996.0,1573.71159
6590020029,MAGNESIUM SULPHATE 50% INJ -5ML,Medicine,Rayan Hospital,RYN_IP,,,,1150361200,15-03-2024,2.1,-8.4,8546103.0,PCS,Issue to Patient,4.0,1.58003,-6.32013,992.0,1567.39147
6590020029,MAGNESIUM SULPHATE 50% INJ -5ML,Medicine,Rayan Hospital,RYN_IP,,,,1150362404,15-03-2024,2.1,-2.1,8546103.0,PCS,Issue to Patient,1.0,1.58003,-1.58003,991.0,1565.81143
6590020029,MAGNESIUM SULPHATE 50% INJ -5ML,Medicine,Rayan Hospital,RYN_IP,,,,1150362419,15-03-2024,2.1,-2.1,8546103.0,PCS,Issue to Patient,1.0,1.58003,-1.58003,990.0,1564.2314
6590020029,MAGNESIUM SULPHATE 50% INJ -5ML,Medicine,Rayan Hospital,RYN_IP,,,,1150363621,15-03-2024,2.1,-2.1,8546103.0,PCS,Issue to Patient,1.0,1.58003,-1.58003,989.0,1562.65137
6590020029,MAGNESIUM SULPHATE 50% INJ -5ML,Medicine,Rayan Hospital,RYN_IP,,,,1150363626,15-03-2024,2.1,-2.1,8546103.0,PCS,Issue to Patient,1.0,1.58003,-1.58003,988.0,1561.07134
6590020029,MAGNESIUM SULPHATE 50% INJ -5ML,Medicine,Rayan Hospital,RYN_IP,,,,1150364531,15-03-2024,2.1,-2.1,8546103.0,PCS,Issue to Patient,1.0,1.58003,-1.58003,987.0,1559.49131
6590020029,MAGNESIUM SULPHATE 50% INJ -5ML,Medicine,Rayan Hospital,RYN_IP,,,,1150364556,15-03-2024,2.1,-2.1,8546103.0,PCS,Issue to Patient,1.0,1.58003,-1.58003,986.0,1557.91128
6590020029,MAGNESIUM SULPHATE 50% INJ -5ML,Medicine,Rayan Hospital,RYN_IP,,,,1150364576,15-03-2024,2.1,-2.1,8546103.0,PCS,Issue to Patient,1.0,1.58003,-1.58003,985.0,1556.33124
6590020029,MAGNESIUM SULPHATE 50% INJ -5ML,Medicine,Rayan Hospital,RYN_IP,,,,1150370731,15-03-2024,2.1,-6.3,8546104.0,PCS,Issue to Patient,3.0,1.58003,-4.7401,982.0,1551.59115
6590020029,MAGNESIUM SULPHATE 50% INJ -5ML,Medicine,Rayan Hospital,RYN_IP,,,,1150408130,15-03-2024,2.1,-2.1,8546104.0,PCS,Issue to Patient,1.0,1.58003,-1.58003,981.0,1550.01112
6590020029,MAGNESIUM SULPHATE 50% INJ -5ML,Medicine,Rayan Hospital,RYN_IP,,,,1150451272,16-03-2024,2.1,-4.2,8546104.0,PCS,Issue to Patient,2.0,1.58003,-3.16006,979.0,1546.85105
6590020029,MAGNESIUM SULPHATE 50% INJ -5ML,Medicine,Rayan Hospital,RYN_IP,,,,1150469458,16-03-2024,2.1,-6.3,8546104.0,PCS,Issue to Patient,3.0,1.58003,-4.7401,976.0,1542.11096
6590020029,MAGNESIUM SULPHATE 50% INJ -5ML,Medicine,Rayan Hospital,RYN_IP,,,,1150512650,16-03-2024,2.1,-6.3,8546104.0,PCS,Issue to Patient,3.0,1.58003,-4.7401,973.0,1537.37086
6590020029,MAGNESIUM SULPHATE 50% INJ -5ML,Medicine,Rayan Hospital,RYN_IP,,,,1150565588,16-03-2024,2.1,-2.1,8546103.0,PCS,Issue to Patient,1.0,1.58003,-1.58003,972.0,1535.79083
6590020029,MAGNESIUM SULPHATE 50% INJ -5ML,Medicine,Rayan Hospital,RYN_IP,,,,1150591615,16-03-2024,2.1,-2.1,8546106.0,PCS,Issue to Patient,1.0,1.58003,-1.58003,972.0,1535.79083
6590020029,MAGNESIUM SULPHATE 50% INJ -5ML,Medicine,Rayan Hospital,RYN_IP,,,,1150591650,16-03-2024,2.1,-2.1,8546103.0,PCS,Issue to Patient,1.0,1.58003,-1.58003,971.0,1534.2108
6590020029,MAGNESIUM SULPHATE 50% INJ -5ML,Medicine,Rayan Hospital,RYN_IP,,,,1150591917,16-03-2024,2.1,-2.1,8546106.0,PCS,Issue to Patient,1.0,1.58003,-1.58003,970.0,1532.63077
6590020029,MAGNESIUM SULPHATE 50% INJ -5ML,Medicine,Rayan Hospital,RYN_IP,,,,1150593082,16-03-2024,2.1,-2.1,8546106.0,PCS,Issue to Patient,1.0,1.58003,-1.58003,969.0,1531.05074
6590020029,MAGNESIUM SULPHATE 50% INJ -5ML,Medicine,Rayan Hospital,RYN_IP,,,,1150603064,16-03-2024,2.1,-2.1,8546106.0,PCS,Issue to Patient,1.0,1.58003,-1.58003,968.0,1529.4707
6590020029,MAGNESIUM SULPHATE 50% INJ -5ML,Medicine,Rayan Hospital,RYN_IP,,,,1150603442,16-03-2024,2.1,-2.1,8546106.0,PCS,Issue to Patient,1.0,1.58003,-1.58003,967.0,1527.89067
6590020029,MAGNESIUM SULPHATE 50% INJ -5ML,Medicine,Rayan Hospital,RYN_IP,,,,1150606288,16-03-2024,2.1,-2.1,8546106.0,PCS,Issue to Patient,1.0,1.58003,-1.58003,966.0,1526.31064
6590020029,MAGNESIUM SULPHATE 50% INJ -5ML,Medicine,Rayan Hospital,RYN_IP,,,,1150607478,16-03-2024,2.1,-2.1,8546106.0,PCS,Issue to Patient,1.0,1.58003,-1.58003,965.0,1524.73061
6590020029,MAGNESIUM SULPHATE 50% INJ -5ML,Medicine,Rayan Hospital,RYN_IP,,,,1150609166,16-03-2024,2.1,-2.1,8546106.0,PCS,Issue to Patient,1.0,1.58003,-1.58003,964.0,1523.15058
6590020029,MAGNESIUM SULPHATE 50% INJ -5ML,Medicine,Rayan Hospital,RYN_IP,,,,1150663073,16-03-2024,2.1,-2.1,8546103.0,PCS,Issue to Patient,1.0,1.58003,-1.58003,963.0,1521.57055
6590020029,MAGNESIUM SULPHATE 50% INJ -5ML,Medicine,Rayan Hospital,RYN_IP,,,,1150756021,16-03-2024,2.1,-4.2,8546103.0,PCS,Issue to Patient,2.0,1.58003,-3.16006,961.0,1518.41048
6590020029,MAGNESIUM SULPHATE 50% INJ -5ML,Medicine,Rayan Hospital,RYN_IP,,,,1150765472,16-03-2024,2.1,-2.1,8546103.0,PCS,Issue to Patient,1.0,1.58003,-1.58003,960.0,1516.83045
6590020029,MAGNESIUM SULPHATE 50% INJ -5ML,Medicine,Rayan Hospital,RYN_IP,,,,1150774295,16-03-2024,2.1,-4.2,8546103.0,PCS,Issue to Patient,2.0,1.58003,-3.16006,958.0,1513.67039
6590020029,MAGNESIUM SULPHATE 50% INJ -5ML,Medicine,Rayan Hospital,RYN_IP,,,,1150788060,16-03-2024,2.1,-4.2,8546103.0,PCS,Issue to Patient,2.0,1.58003,-3.16006,956.0,1510.51032
6590020029,MAGNESIUM SULPHATE 50% INJ -5ML,Medicine,Rayan Hospital,RYN_IP,,,,1151027753,17-03-2024,2.1,-2.1,8546103.0,PCS,Issue to Patient,1.0,1.58003,-1.58003,955.0,1508.93029
6590020029,MAGNESIUM SULPHATE 50% INJ -5ML,Medicine,Rayan Hospital,RYN_IP,,,,1151029833,17-03-2024,2.1,-2.1,8546104.0,PCS,Issue to Patient,1.0,1.58003,-1.58003,954.0,1507.35026
6590020029,MAGNESIUM SULPHATE 50% INJ -5ML,Medicine,Rayan Hospital,STAGE,Rayan Hospital Clinics,RAY_ER,17526220,1151034300,17-03-2024,2.1,-21.0,8546104.0,PCS,Int Order Direct Ship,10.0,1.58003,-15.80032,944.0,1491.54994
6590020029,MAGNESIUM SULPHATE 50% INJ -5ML,Medicine,Rayan Hospital,RYN_IP,,,,1151070215,17-03-2024,2.1,-4.2,8546103.0,PCS,Issue to Patient,2.0,1.58003,-3.16006,942.0,1488.38988
6590020029,MAGNESIUM SULPHATE 50% INJ -5ML,Medicine,Rayan Hospital,STAGE,Rayan Hospital Clinics,RAY_ANSTHA,17527917,1151092341,17-03-2024,2.1,-21.0,8546104.0,PCS,Int Order Direct Ship,10.0,1.58003,-15.80032,932.0,1472.58956
6590020029,MAGNESIUM SULPHATE 50% INJ -5ML,Medicine,Rayan Hospital,RYN_IP,,,,1151160869,17-03-2024,2.1,-2.1,8546103.0,PCS,Issue to Patient,1.0,1.58003,-1.58003,931.0,1471.00953
6590020029,MAGNESIUM SULPHATE 50% INJ -5ML,Medicine,Rayan Hospital,RYN_IP,,,,1151164466,17-03-2024,2.1,-2.1,8546103.0,PCS,Issue to Patient,1.0,1.58003,-1.58003,930.0,1469.4295
6590020029,MAGNESIUM SULPHATE 50% INJ -5ML,Medicine,Rayan Hospital,RYN_IP,,,,1151170677,17-03-2024,2.1,-2.1,8546103.0,PCS,Issue to Patient,1.0,1.58003,-1.58003,929.0,1467.84947
6590020029,MAGNESIUM SULPHATE 50% INJ -5ML,Medicine,Rayan Hospital,RYN_IP,,,,1151170804,17-03-2024,2.1,-2.1,8546103.0,PCS,Issue to Patient,1.0,1.58003,-1.58003,928.0,1466.26944
6590020029,MAGNESIUM SULPHATE 50% INJ -5ML,Medicine,Rayan Hospital,RYN_IP,,,,1151171002,17-03-2024,2.1,-2.1,8546103.0,PCS,Issue to Patient,1.0,1.58003,-1.58003,927.0,1464.6894
6590020029,MAGNESIUM SULPHATE 50% INJ -5ML,Medicine,Rayan Hospital,RYN_IP,,,,1151235773,17-03-2024,2.1,-2.1,8546103.0,PCS,Issue to Patient,1.0,1.58003,-1.58003,926.0,1463.10937
6590020029,MAGNESIUM SULPHATE 50% INJ -5ML,Medicine,Rayan Hospital,RYN_IP,,,,1151238960,17-03-2024,2.1,-2.1,8546103.0,PCS,Issue to Patient,1.0,1.58003,-1.58003,925.0,1461.52934
6590020029,MAGNESIUM SULPHATE 50% INJ -5ML,Medicine,Rayan Hospital,RYN_IP,,,,1151239025,17-03-2024,2.1,-2.1,8546103.0,PCS,Issue to Patient,1.0,1.58003,-1.58003,924.0,1459.94931
6590020029,MAGNESIUM SULPHATE 50% INJ -5ML,Medicine,Rayan Hospital,RYN_IP,,,,1151274747,17-03-2024,2.1,-2.1,8546104.0,PCS,Issue to Patient,1.0,1.58003,-1.58003,923.0,1458.36928
6590020029,MAGNESIUM SULPHATE 50% INJ -5ML,Medicine,Rayan Hospital,RYN_IP,,,,1151304740,17-03-2024,2.1,-8.4,8546104.0,PCS,Issue to Patient,4.0,1.58003,-6.32013,919.0,1452.04915
6590020029,MAGNESIUM SULPHATE 50% INJ -5ML,Medicine,Rayan Hospital,RYN_IP,,,,1151310225,17-03-2024,2.1,-4.2,8546103.0,PCS,Issue to Patient,2.0,1.58003,-3.16006,917.0,1448.88909
6590020029,MAGNESIUM SULPHATE 50% INJ -5ML,Medicine,Rayan Hospital,RYN_IP,,,,1151333544,17-03-2024,2.1,-2.1,8546103.0,PCS,Issue to Patient,1.0,1.58003,-1.58003,916.0,1447.30906
6590020029,MAGNESIUM SULPHATE 50% INJ -5ML,Medicine,Rayan Hospital,RYN_IP,,,,1151528336,18-03-2024,2.1,-2.1,8546104.0,PCS,Issue to Patient,1.0,1.58003,-1.58003,915.0,1445.72902
6590020029,MAGNESIUM SULPHATE 50% INJ -5ML,Medicine,Rayan Hospital,RYN_IP,,,,1151558722,18-03-2024,2.1,-4.2,8546103.0,PCS,Issue to Patient,2.0,1.58003,-3.16006,913.0,1442.56896
6590020029,MAGNESIUM SULPHATE 50% INJ -5ML,Medicine,Rayan Hospital,RYN_IP,,,,1151576750,18-03-2024,2.1,-6.3,8546104.0,PCS,Issue to Patient,3.0,1.58003,-4.7401,910.0,1437.82886
6590020029,MAGNESIUM SULPHATE 50% INJ -5ML,Medicine,Rayan Hospital,RYN_IP,,,,1151593413,18-03-2024,2.1,-4.2,8546103.0,PCS,Issue to Patient,2.0,1.58003,-3.16006,908.0,1434.6688
6590020029,MAGNESIUM SULPHATE 50% INJ -5ML,Medicine,Rayan Hospital,RYN_IP,,,,1151604739,18-03-2024,2.1,-4.2,8546104.0,PCS,Issue to Patient,2.0,1.58003,-3.16006,906.0,1431.50874
6590020029,MAGNESIUM SULPHATE 50% INJ -5ML,Medicine,Rayan Hospital,RYN_IP,,,,1151623603,18-03-2024,2.1,-4.2,8546103.0,PCS,Issue to Patient,2.0,1.58003,-3.16006,904.0,1428.34867
6590020029,MAGNESIUM SULPHATE 50% INJ -5ML,Medicine,Rayan Hospital,RYN_IP,,,,1151692055,18-03-2024,2.1,-2.1,8546106.0,PCS,Issue to Patient,1.0,1.58003,-1.58003,903.0,1426.76864
6590020029,MAGNESIUM SULPHATE 50% INJ -5ML,Medicine,Rayan Hospital,RYN_IP,,,,1151778011,18-03-2024,2.1,-2.1,8546104.0,PCS,Issue to Patient,1.0,1.58003,-1.58003,902.0,1425.18861
6590020029,MAGNESIUM SULPHATE 50% INJ -5ML,Medicine,Rayan Hospital,RYN_IP,,,,1151801976,18-03-2024,2.1,-2.1,8546106.0,PCS,Issue to Patient,1.0,1.58003,-1.58003,901.0,1423.60858
6590020029,MAGNESIUM SULPHATE 50% INJ -5ML,Medicine,Rayan Hospital,RYN_IP,,,,1151802512,18-03-2024,2.1,-2.1,8546106.0,PCS,Issue to Patient,1.0,1.58003,-1.58003,900.0,1422.02855
6590020029,MAGNESIUM SULPHATE 50% INJ -5ML,Medicine,Rayan Hospital,RYN_IP,,,,1151806109,18-03-2024,2.1,-2.1,8546106.0,PCS,Issue to Patient,1.0,1.58003,-1.58003,899.0,1420.44852
6590020029,MAGNESIUM SULPHATE 50% INJ -5ML,Medicine,Rayan Hospital,RYN_IP,,,,1151806355,18-03-2024,2.1,-2.1,8546106.0,PCS,Issue to Patient,1.0,1.58003,-1.58003,898.0,1418.86848
6590020029,MAGNESIUM SULPHATE 50% INJ -5ML,Medicine,Rayan Hospital,RYN_IP,,,,1151806620,18-03-2024,2.1,-2.1,8546106.0,PCS,Issue to Patient,1.0,1.58003,-1.58003,897.0,1417.28845
6590020029,MAGNESIUM SULPHATE 50% INJ -5ML,Medicine,Rayan Hospital,RYN_IP,,,,1151807369,18-03-2024,2.1,-2.1,8546106.0,PCS,Issue to Patient,1.0,1.58003,-1.58003,896.0,1415.70842
6590020029,MAGNESIUM SULPHATE 50% INJ -5ML,Medicine,Rayan Hospital,RYN_IP,,,,1152122461,19-03-2024,2.1,-2.1,8546103.0,PCS,Issue to Patient,1.0,1.58003,-1.58003,895.0,1414.12839
6590020029,MAGNESIUM SULPHATE 50% INJ -5ML,Medicine,Rayan Hospital,RYN_IP,,,,1152123084,19-03-2024,2.1,-2.1,8546104.0,PCS,Issue to Patient,1.0,1.58003,-1.58003,894.0,1412.54836
6590020029,MAGNESIUM SULPHATE 50% INJ -5ML,Medicine,Rayan Hospital,RYN_IP,,,,1152159421,19-03-2024,2.1,-2.1,8546103.0,PCS,Issue to Patient,1.0,1.58003,-1.58003,894.0,1412.54836
6590020029,MAGNESIUM SULPHATE 50% INJ -5ML,Medicine,Rayan Hospital,RYN_IP,,,,1152190760,19-03-2024,2.1,-4.2,8546103.0,PCS,Issue to Patient,2.0,1.58003,-3.16006,892.0,1409.38829
6590020029,MAGNESIUM SULPHATE 50% INJ -5ML,Medicine,Rayan Hospital,RYN_IP,,,,1152221122,19-03-2024,2.1,-4.2,8546103.0,PCS,Issue to Patient,2.0,1.58003,-3.16006,890.0,1406.22823
6590020029,MAGNESIUM SULPHATE 50% INJ -5ML,Medicine,Rayan Hospital,RYN_IP,,,,1152239394,19-03-2024,2.1,-2.1,8546103.0,PCS,Issue to Patient,1.0,1.58003,-1.58003,889.0,1404.6482
6590020029,MAGNESIUM SULPHATE 50% INJ -5ML,Medicine,Rayan Hospital,RYN_IP,,,,1152239657,19-03-2024,2.1,-2.1,8546103.0,PCS,Issue to Patient,1.0,1.58003,-1.58003,888.0,1403.06817
6590020029,MAGNESIUM SULPHATE 50% INJ -5ML,Medicine,Rayan Hospital,RYN_IP,,,,1152242001,19-03-2024,2.1,-2.1,8546103.0,PCS,Issue to Patient,1.0,1.58003,-1.58003,887.0,1401.48814
6590020029,MAGNESIUM SULPHATE 50% INJ -5ML,Medicine,Rayan Hospital,RYN_IP,,,,1152250697,19-03-2024,2.1,-2.1,8546103.0,PCS,Issue to Patient,1.0,1.58003,-1.58003,886.0,1399.9081
6590020029,MAGNESIUM SULPHATE 50% INJ -5ML,Medicine,Rayan Hospital,RYN_IP,,,,1152250702,19-03-2024,2.1,-2.1,8546103.0,PCS,Issue to Patient,1.0,1.58003,-1.58003,885.0,1398.32807
6590020029,MAGNESIUM SULPHATE 50% INJ -5ML,Medicine,Rayan Hospital,RYN_IP,,,,1152250960,19-03-2024,2.1,-2.1,8546103.0,PCS,Issue to Patient,1.0,1.58003,-1.58003,884.0,1396.74804
6590020029,MAGNESIUM SULPHATE 50% INJ -5ML,Medicine,Rayan Hospital,RYN_IP,,,,1152252437,19-03-2024,2.1,-2.1,8546103.0,PCS,Issue to Patient,1.0,1.58003,-1.58003,883.0,1395.16801
6590020029,MAGNESIUM SULPHATE 50% INJ -5ML,Medicine,Rayan Hospital,RYN_IP,,,,1152298150,19-03-2024,2.1,-2.1,8546103.0,PCS,Issue to Patient,1.0,1.58003,-1.58003,882.0,1393.58798
6590020029,MAGNESIUM SULPHATE 50% INJ -5ML,Medicine,Rayan Hospital,RYN_IP,,,,1152301913,19-03-2024,2.1,-2.1,8546104.0,PCS,Issue to Patient,1.0,1.58003,-1.58003,881.0,1392.00794
6590020029,MAGNESIUM SULPHATE 50% INJ -5ML,Medicine,Rayan Hospital,RYN_IP,,,,1152375827,19-03-2024,2.1,-2.1,8546104.0,PCS,Issue to Patient,1.0,1.58003,-1.58003,880.0,1390.42791
6590020029,MAGNESIUM SULPHATE 50% INJ -5ML,Medicine,Rayan Hospital,RYN_IP,,,,1152423684,19-03-2024,2.1,-2.1,8546104.0,PCS,Issue to Patient,1.0,1.58003,-1.58003,879.0,1388.84788
6590020029,MAGNESIUM SULPHATE 50% INJ -5ML,Medicine,Rayan Hospital,RYN_IP,,,,1152425959,19-03-2024,2.1,-4.2,8546104.0,PCS,Issue to Patient,2.0,1.58003,-3.16006,877.0,1385.68782
6590020029,MAGNESIUM SULPHATE 50% INJ -5ML,Medicine,Rayan Hospital,RYN_IP,,,,1152433860,19-03-2024,2.1,-6.3,8546104.0,PCS,Issue to Patient,3.0,1.58003,-4.7401,874.0,1380.94772
6590020029,MAGNESIUM SULPHATE 50% INJ -5ML,Medicine,Rayan Hospital,RYN_IP,,,,1152442864,19-03-2024,2.1,-4.2,8546104.0,PCS,Issue to Patient,2.0,1.58003,-3.16006,872.0,1377.78766
6590020029,MAGNESIUM SULPHATE 50% INJ -5ML,Medicine,Rayan Hospital,RYN_IP,,,,1152617229,20-03-2024,2.1,-4.2,8546104.0,PCS,Issue to Patient,2.0,1.58003,-3.16006,870.0,1374.6276
6590020029,MAGNESIUM SULPHATE 50% INJ -5ML,Medicine,Rayan Hospital,RYN_IP,,,,1152622293,20-03-2024,2.1,-8.4,8546103.0,PCS,Issue to Patient,4.0,1.58003,-6.32013,866.0,1368.30747
6590020029,MAGNESIUM SULPHATE 50% INJ -5ML,Medicine,Rayan Hospital,RYN_IP,,,,1152646756,20-03-2024,2.1,-2.1,8546104.0,PCS,Issue to Patient,1.0,1.58003,-1.58003,865.0,1366.72744
6590020029,MAGNESIUM SULPHATE 50% INJ -5ML,Medicine,Rayan Hospital,RYN_IP,,,,1152655151,20-03-2024,2.1,-2.1,8546103.0,PCS,Issue to Patient,1.0,1.58003,-1.58003,864.0,1365.14741
6590020029,MAGNESIUM SULPHATE 50% INJ -5ML,Medicine,Rayan Hospital,RYN_IP,,,,1152675750,20-03-2024,2.1,-4.2,8546104.0,PCS,Issue to Patient,2.0,1.58003,-3.16006,863.0,1363.56737
6590020029,MAGNESIUM SULPHATE 50% INJ -5ML,Medicine,Rayan Hospital,RYN_IP,,,,1152698628,20-03-2024,2.1,-2.1,8546104.0,PCS,Issue to Patient,1.0,1.58003,-1.58003,862.0,1361.98734
6590020029,MAGNESIUM SULPHATE 50% INJ -5ML,Medicine,Rayan Hospital,STAGE,Rayan Hospital Clinics,RAY_ER,17527906,1152710074,20-03-2024,2.1,-10.5,8546104.0,PCS,Int Order Direct Ship,5.0,1.58003,-7.90016,857.0,1354.08718
6590020029,MAGNESIUM SULPHATE 50% INJ -5ML,Medicine,Rayan Hospital,RYN_IP,,,,1152719669,20-03-2024,2.1,-8.4,8546103.0,PCS,Issue to Patient,4.0,1.58003,-6.32013,853.0,1347.76706
6590020029,MAGNESIUM SULPHATE 50% INJ -5ML,Medicine,Rayan Hospital,RYN_IP,,,,1152721758,20-03-2024,2.1,-4.2,8546103.0,PCS,Issue to Patient,2.0,1.58003,-3.16006,851.0,1344.60699
6590020029,MAGNESIUM SULPHATE 50% INJ -5ML,Medicine,Rayan Hospital,RYN_IP,,,,1152737172,20-03-2024,2.1,-4.2,8546104.0,PCS,Issue to Patient,2.0,1.58003,-3.16006,849.0,1341.44693
6590020029,MAGNESIUM SULPHATE 50% INJ -5ML,Medicine,Rayan Hospital,RYN_IP,,,,1152817629,20-03-2024,2.1,-2.1,8546103.0,PCS,Issue to Patient,1.0,1.58003,-1.58003,848.0,1339.8669
6590020029,MAGNESIUM SULPHATE 50% INJ -5ML,Medicine,Rayan Hospital,RYN_IP,,,,1152818227,20-03-2024,2.1,-2.1,8546103.0,PCS,Issue to Patient,1.0,1.58003,-1.58003,847.0,1338.28687
6590020029,MAGNESIUM SULPHATE 50% INJ -5ML,Medicine,Rayan Hospital,RYN_IP,,,,1152822127,20-03-2024,2.1,-2.1,8546103.0,PCS,Issue to Patient,1.0,1.58003,-1.58003,846.0,1336.70683
6590020029,MAGNESIUM SULPHATE 50% INJ -5ML,Medicine,Rayan Hospital,RYN_IP,,,,1152827869,20-03-2024,2.1,-2.1,8546103.0,PCS,Issue to Patient,1.0,1.58003,-1.58003,845.0,1335.1268
6590020029,MAGNESIUM SULPHATE 50% INJ -5ML,Medicine,Rayan Hospital,RYN_IP,,,,1152827879,20-03-2024,2.1,-4.2,8546104.0,PCS,Issue to Patient,2.0,1.58003,-3.16006,843.0,1331.96674
6590020029,MAGNESIUM SULPHATE 50% INJ -5ML,Medicine,Rayan Hospital,RYN_IP,,,,1152827889,20-03-2024,2.1,-2.1,8546103.0,PCS,Issue to Patient,1.0,1.58003,-1.58003,842.0,1330.38671
6590020029,MAGNESIUM SULPHATE 50% INJ -5ML,Medicine,Rayan Hospital,RYN_IP,,,,1152827904,20-03-2024,2.1,-2.1,8546103.0,PCS,Issue to Patient,1.0,1.58003,-1.58003,841.0,1328.80668
6590020029,MAGNESIUM SULPHATE 50% INJ -5ML,Medicine,Rayan Hospital,STAGE,Rayan Hospital Clinics,RAY_ER,17529695,1152849360,20-03-2024,2.1,-8.4,854698.0,PCS,Int Order Direct Ship,4.0,1.58003,-6.32013,837.0,1322.48655
6590020029,MAGNESIUM SULPHATE 50% INJ -5ML,Medicine,Rayan Hospital,RYN_IP,,,,1152860365,20-03-2024,2.1,-2.1,8546104.0,PCS,Issue to Patient,1.0,1.58003,-1.58003,836.0,1320.90652
6590020029,MAGNESIUM SULPHATE 50% INJ -5ML,Medicine,Rayan Hospital,RYN_IP,,,,1152908969,20-03-2024,2.1,-4.2,8546104.0,PCS,Issue to Patient,2.0,1.58003,-3.16006,834.0,1317.74645
6590020029,MAGNESIUM SULPHATE 50% INJ -5ML,Medicine,Rayan Hospital,RYN_IP,,,,1152937514,20-03-2024,2.1,-4.2,8546106.0,PCS,Issue to Patient,2.0,1.58003,-3.16006,832.0,1314.58639
6590020029,MAGNESIUM SULPHATE 50% INJ -5ML,Medicine,Rayan Hospital,RYN_IP,,,,1152947796,20-03-2024,2.1,-8.4,8546103.0,PCS,Issue to Patient,4.0,1.58003,-6.32013,828.0,1308.26626
6590020029,MAGNESIUM SULPHATE 50% INJ -5ML,Medicine,Rayan Hospital,RYN_IP,,,,1153002777,20-03-2024,2.1,-2.1,8546104.0,PCS,Issue to Patient,1.0,1.58003,-1.58003,827.0,1306.68623
6590020029,MAGNESIUM SULPHATE 50% INJ -5ML,Medicine,Rayan Hospital,RYN_IP,,,,1153064455,20-03-2024,2.1,-8.4,8546104.0,PCS,Issue to Patient,4.0,1.58003,-6.32013,823.0,1300.36611
6590020029,MAGNESIUM SULPHATE 50% INJ -5ML,Medicine,Rayan Hospital,RYN_IP,,,,1153353812,21-03-2024,2.1,-2.1,8546106.0,PCS,Issue to Patient,1.0,1.58003,-1.58003,822.0,1298.78607
6590020029,MAGNESIUM SULPHATE 50% INJ -5ML,Medicine,Rayan Hospital,RYN_IP,,,,1153368512,21-03-2024,2.1,-2.1,8546106.0,PCS,Issue to Patient,1.0,1.58003,-1.58003,821.0,1297.20604
6590020029,MAGNESIUM SULPHATE 50% INJ -5ML,Medicine,Rayan Hospital,RYN_IP,,,,1153659289,22-03-2024,2.1,-4.2,8546104.0,PCS,Issue to Patient,2.0,1.58003,-3.16006,819.0,1294.04598
6590020029,MAGNESIUM SULPHATE 50% INJ -5ML,Medicine,Rayan Hospital,RYN_IP,,,,1153723880,22-03-2024,2.1,-4.2,8546104.0,PCS,Issue to Patient,2.0,1.58003,-3.16006,817.0,1290.88591
6590020029,MAGNESIUM SULPHATE 50% INJ -5ML,Medicine,Rayan Hospital,RYN_IP,,,,1153756306,22-03-2024,2.1,-4.2,8546103.0,PCS,Issue to Patient,2.0,1.58003,-3.16006,815.0,1287.72585
6590020029,MAGNESIUM SULPHATE 50% INJ -5ML,Medicine,Rayan Hospital,RYN_IP,,,,1153764166,22-03-2024,2.1,-2.1,8546106.0,PCS,Issue to Patient,1.0,1.58003,-1.58003,814.0,1286.14582
6590020029,MAGNESIUM SULPHATE 50% INJ -5ML,Medicine,Rayan Hospital,RYN_IP,,,,1153774726,22-03-2024,2.1,-2.1,8546106.0,PCS,Issue to Patient,1.0,1.58003,-1.58003,813.0,1284.56579
6590020029,MAGNESIUM SULPHATE 50% INJ -5ML,Medicine,Rayan Hospital,RYN_IP,,,,1153778600,22-03-2024,2.1,-2.1,8546104.0,PCS,Issue to Patient,1.0,1.58003,-1.58003,812.0,1282.98576
6590020029,MAGNESIUM SULPHATE 50% INJ -5ML,Medicine,Rayan Hospital,RYN_IP,,,,1153787182,22-03-2024,2.1,-4.2,8546104.0,PCS,Issue to Patient,2.0,1.58003,-3.16006,810.0,1279.82569
6590020029,MAGNESIUM SULPHATE 50% INJ -5ML,Medicine,Rayan Hospital,RYN_IP,,,,1153789984,22-03-2024,2.1,-2.1,8546104.0,PCS,Issue to Patient,1.0,1.58003,-1.58003,809.0,1278.24566
6590020029,MAGNESIUM SULPHATE 50% INJ -5ML,Medicine,Rayan Hospital,RYN_IP,,,,1153795684,22-03-2024,2.1,-2.1,8546104.0,PCS,Issue to Patient,1.0,1.58003,-1.58003,808.0,1276.66563
6590020029,MAGNESIUM SULPHATE 50% INJ -5ML,Medicine,Rayan Hospital,RYN_IP,,,,1153797374,22-03-2024,2.1,-2.1,8546103.0,PCS,Issue to Patient,1.0,1.58003,-1.58003,807.0,1275.0856
6590020029,MAGNESIUM SULPHATE 50% INJ -5ML,Medicine,Rayan Hospital,RYN_IP,,,,1153797599,22-03-2024,2.1,-2.1,8546103.0,PCS,Issue to Patient,1.0,1.58003,-1.58003,806.0,1273.50557
6590020029,MAGNESIUM SULPHATE 50% INJ -5ML,Medicine,Rayan Hospital,RYN_IP,,,,1153828543,22-03-2024,2.1,-4.2,8546103.0,PCS,Issue to Patient,2.0,1.58003,-3.16006,804.0,1270.3455
6590020029,MAGNESIUM SULPHATE 50% INJ -5ML,Medicine,Rayan Hospital,RYN_IP,,,,1153904604,23-03-2024,2.1,-4.2,8546104.0,PCS,Issue to Patient,2.0,1.58003,-3.16006,802.0,1267.18544
6590020029,MAGNESIUM SULPHATE 50% INJ -5ML,Medicine,Rayan Hospital,RYN_IP,,,,1153937077,23-03-2024,2.1,-2.1,8546103.0,PCS,Issue to Patient,1.0,1.58003,-1.58003,801.0,1265.60541
6590020029,MAGNESIUM SULPHATE 50% INJ -5ML,Medicine,Rayan Hospital,RYN_IP,,,,1153999830,23-03-2024,2.1,-2.1,8546103.0,PCS,Issue to Patient,1.0,1.58003,-1.58003,800.0,1264.02538
6590020029,MAGNESIUM SULPHATE 50% INJ -5ML,Medicine,Rayan Hospital,RYN_IP,,,,1154018264,23-03-2024,2.1,-2.1,8546104.0,PCS,Issue to Patient,1.0,1.58003,-1.58003,799.0,1262.44534
6590020029,MAGNESIUM SULPHATE 50% INJ -5ML,Medicine,Rayan Hospital,RYN_IP,,,,1154066530,23-03-2024,2.1,-2.1,8546106.0,PCS,Issue to Patient,1.0,1.58003,-1.58003,798.0,1260.86531
6590020029,MAGNESIUM SULPHATE 50% INJ -5ML,Medicine,Rayan Hospital,RYN_IP,,,,1154086237,23-03-2024,2.1,-2.1,8546103.0,PCS,Issue to Patient,1.0,1.58003,-1.58003,797.0,1259.28528
6590020029,MAGNESIUM SULPHATE 50% INJ -5ML,Medicine,Rayan Hospital,RYN_IP,,,,1154094647,23-03-2024,2.1,-2.1,8546106.0,PCS,Issue to Patient,1.0,1.58003,-1.58003,796.0,1257.70525
6590020029,MAGNESIUM SULPHATE 50% INJ -5ML,Medicine,Rayan Hospital,RYN_IP,,,,1154097514,23-03-2024,2.1,-2.1,8546106.0,PCS,Issue to Patient,1.0,1.58003,-1.58003,795.0,1256.12522
6590020029,MAGNESIUM SULPHATE 50% INJ -5ML,Medicine,Rayan Hospital,RYN_IP,,,,1154098352,23-03-2024,2.1,-2.1,8546103.0,PCS,Issue to Patient,1.0,1.58003,-1.58003,794.0,1254.54519
6590020029,MAGNESIUM SULPHATE 50% INJ -5ML,Medicine,Rayan Hospital,RYN_IP,,,,1154101818,23-03-2024,2.1,-2.1,8546106.0,PCS,Issue to Patient,1.0,1.58003,-1.58003,793.0,1252.96515
6590020029,MAGNESIUM SULPHATE 50% INJ -5ML,Medicine,Rayan Hospital,RYN_IP,,,,1154115810,23-03-2024,2.1,-2.1,8546106.0,PCS,Issue to Patient,1.0,1.58003,-1.58003,792.0,1251.38512
6590020029,MAGNESIUM SULPHATE 50% INJ -5ML,Medicine,Rayan Hospital,RYN_IP,,,,1154115969,23-03-2024,2.1,-2.1,8546103.0,PCS,Issue to Patient,1.0,1.58003,-1.58003,791.0,1249.80509
6590020029,MAGNESIUM SULPHATE 50% INJ -5ML,Medicine,Rayan Hospital,RYN_IP,,,,1154172506,23-03-2024,2.1,-4.2,8546104.0,PCS,Issue to Patient,2.0,1.58003,-3.16006,789.0,1246.64503
6590020029,MAGNESIUM SULPHATE 50% INJ -5ML,Medicine,Rayan Hospital,RYN_IP,,,,1154499114,24-03-2024,2.1,-4.2,8546104.0,PCS,Issue to Patient,2.0,1.58003,-3.16006,787.0,1243.48496
6590020029,MAGNESIUM SULPHATE 50% INJ -5ML,Medicine,Rayan Hospital,RYN_IP,,,,1154574192,24-03-2024,2.1,-2.1,8546103.0,PCS,Issue to Patient,1.0,1.58003,-1.58003,786.0,1241.90493
6590020029,MAGNESIUM SULPHATE 50% INJ -5ML,Medicine,Rayan Hospital,RYN_IP,,,,1154672746,24-03-2024,2.1,-2.1,8546106.0,PCS,Issue to Patient,1.0,1.58003,-1.58003,785.0,1240.3249
6590020029,MAGNESIUM SULPHATE 50% INJ -5ML,Medicine,Rayan Hospital,RYN_IP,,,,1154675840,24-03-2024,2.1,-2.1,8546106.0,PCS,Issue to Patient,1.0,1.58003,-1.58003,784.0,1238.74487
6590020029,MAGNESIUM SULPHATE 50% INJ -5ML,Medicine,Rayan Hospital,RYN_IP,,,,1154675950,24-03-2024,2.1,-2.1,8546106.0,PCS,Issue to Patient,1.0,1.58003,-1.58003,783.0,1237.16484
6590020029,MAGNESIUM SULPHATE 50% INJ -5ML,Medicine,Rayan Hospital,RYN_IP,,,,1154676264,24-03-2024,2.1,-2.1,8546106.0,PCS,Issue to Patient,1.0,1.58003,-1.58003,782.0,1235.5848
6590020029,MAGNESIUM SULPHATE 50% INJ -5ML,Medicine,Rayan Hospital,RYN_IP,,,,1154680333,24-03-2024,2.1,-2.1,8546106.0,PCS,Issue to Patient,1.0,1.58003,-1.58003,781.0,1234.00477
6590020029,MAGNESIUM SULPHATE 50% INJ -5ML,Medicine,Rayan Hospital,RYN_IP,,,,1154680399,24-03-2024,2.1,-2.1,8546104.0,PCS,Issue to Patient,1.0,1.58003,-1.58003,780.0,1232.42474
6590020029,MAGNESIUM SULPHATE 50% INJ -5ML,Medicine,Rayan Hospital,RYN_IP,,,,1154680895,24-03-2024,2.1,-2.1,8546106.0,PCS,Issue to Patient,1.0,1.58003,-1.58003,779.0,1230.84471
6590020029,MAGNESIUM SULPHATE 50% INJ -5ML,Medicine,Rayan Hospital,RYN_IP,,,,1154682393,24-03-2024,2.1,-4.2,8546103.0,PCS,Issue to Patient,2.0,1.58003,-3.16006,777.0,1227.68465
6590020029,MAGNESIUM SULPHATE 50% INJ -5ML,Medicine,Rayan Hospital,RYN_IP,,,,1154683510,24-03-2024,2.1,-2.1,8546104.0,PCS,Issue to Patient,1.0,1.58003,-1.58003,776.0,1226.10461
6590020029,MAGNESIUM SULPHATE 50% INJ -5ML,Medicine,Rayan Hospital,RYN_IP,,,,1154698302,24-03-2024,2.1,-2.1,8546103.0,PCS,Issue to Patient,1.0,1.58003,-1.58003,775.0,1224.52458
6590020029,MAGNESIUM SULPHATE 50% INJ -5ML,Medicine,Rayan Hospital,RYN_IP,,,,1154754789,24-03-2024,2.1,-2.1,8546104.0,PCS,Issue to Patient,1.0,1.58003,-1.58003,774.0,1222.94455
6590020029,MAGNESIUM SULPHATE 50% INJ -5ML,Medicine,Rayan Hospital,RYN_IP,,,,1154811226,24-03-2024,2.1,-2.1,8546103.0,PCS,Issue to Patient,1.0,1.58003,-1.58003,773.0,1221.36452
6590020029,MAGNESIUM SULPHATE 50% INJ -5ML,Medicine,Rayan Hospital,RYN_IP,,,,1154962269,25-03-2024,2.1,-2.1,8546104.0,PCS,Issue to Patient,1.0,1.58003,-1.58003,772.0,1219.78449
6590020029,MAGNESIUM SULPHATE 50% INJ -5ML,Medicine,Rayan Hospital,RYN_IP,,,,1154980297,25-03-2024,2.1,-4.2,8546103.0,PCS,Issue to Patient,2.0,1.58003,-3.16006,770.0,1216.62442
6590020029,MAGNESIUM SULPHATE 50% INJ -5ML,Medicine,Rayan Hospital,RYN_IP,,,,1155048994,25-03-2024,2.1,-4.2,8546104.0,PCS,Issue to Patient,2.0,1.58003,-3.16006,768.0,1213.46436
6590020029,MAGNESIUM SULPHATE 50% INJ -5ML,Medicine,Rayan Hospital,RYN_IP,,,,1155127653,25-03-2024,2.1,-2.1,8546103.0,PCS,Issue to Patient,1.0,1.58003,-1.58003,767.0,1211.88433
6590020029,MAGNESIUM SULPHATE 50% INJ -5ML,Medicine,Rayan Hospital,RYN_IP,,,,1155181772,25-03-2024,2.1,-2.1,8546103.0,PCS,Issue to Patient,1.0,1.58003,-1.58003,766.0,1210.3043
6590020029,MAGNESIUM SULPHATE 50% INJ -5ML,Medicine,Rayan Hospital,RYN_IP,,,,1155187975,25-03-2024,2.1,-2.1,8546103.0,PCS,Issue to Patient,1.0,1.58003,-1.58003,765.0,1208.72427
6590020029,MAGNESIUM SULPHATE 50% INJ -5ML,Medicine,Rayan Hospital,RYN_IP,,,,1155193433,25-03-2024,2.1,-2.1,8546103.0,PCS,Issue to Patient,1.0,1.58003,-1.58003,764.0,1207.14423
6590020029,MAGNESIUM SULPHATE 50% INJ -5ML,Medicine,Rayan Hospital,RYN_IP,,,,1155193519,25-03-2024,2.1,-2.1,8546103.0,PCS,Issue to Patient,1.0,1.58003,-1.58003,763.0,1205.5642
6590020029,MAGNESIUM SULPHATE 50% INJ -5ML,Medicine,Rayan Hospital,RYN_IP,,,,1155193599,25-03-2024,2.1,-2.1,8546103.0,PCS,Issue to Patient,1.0,1.58003,-1.58003,762.0,1203.98417
6590020029,MAGNESIUM SULPHATE 50% INJ -5ML,Medicine,Rayan Hospital,RYN_IP,,,,1155232296,25-03-2024,2.1,-2.1,8546104.0,PCS,Issue to Patient,1.0,1.58003,-1.58003,761.0,1202.40414
6590020029,MAGNESIUM SULPHATE 50% INJ -5ML,Medicine,Rayan Hospital,RYN_IP,,,,1155391641,25-03-2024,2.1,-2.1,8546104.0,PCS,Issue to Patient,1.0,1.58003,-1.58003,760.0,1200.82411
6590020029,MAGNESIUM SULPHATE 50% INJ -5ML,Medicine,Rayan Hospital,RYN_IP,,,,1155533494,26-03-2024,2.1,-2.1,8546104.0,PCS,Issue to Patient,1.0,1.58003,-1.58003,759.0,1199.24408
6590020029,MAGNESIUM SULPHATE 50% INJ -5ML,Medicine,Rayan Hospital,RYN_IP,,,,1155533499,26-03-2024,2.1,-4.2,8546104.0,PCS,Issue to Patient,2.0,1.58003,-3.16006,757.0,1196.08401
6590020029,MAGNESIUM SULPHATE 50% INJ -5ML,Medicine,Rayan Hospital,RYN_IP,,,,1155534191,26-03-2024,2.1,-2.1,8546104.0,PCS,Issue to Patient,1.0,1.58003,-1.58003,756.0,1194.50398
6590020029,MAGNESIUM SULPHATE 50% INJ -5ML,Medicine,Rayan Hospital,RYN_IP,,,,1155590175,26-03-2024,2.1,-4.2,8546103.0,PCS,Issue to Patient,2.0,1.58003,-3.16006,754.0,1191.34392
6590020029,MAGNESIUM SULPHATE 50% INJ -5ML,Medicine,Rayan Hospital,RYN_IP,,,,1155599066,26-03-2024,2.1,-2.1,8546104.0,PCS,Issue to Patient,1.0,1.58003,-1.58003,753.0,1189.76388
6590020029,MAGNESIUM SULPHATE 50% INJ -5ML,Medicine,Rayan Hospital,RYN_IP,,,,1155626912,26-03-2024,2.1,-2.1,8546103.0,PCS,Issue to Patient,1.0,1.58003,-1.58003,752.0,1188.18385
6590020029,MAGNESIUM SULPHATE 50% INJ -5ML,Medicine,Rayan Hospital,RYN_IP,,,,1155626922,26-03-2024,2.1,-2.1,8546103.0,PCS,Issue to Patient,1.0,1.58003,-1.58003,751.0,1186.60382
6590020029,MAGNESIUM SULPHATE 50% INJ -5ML,Medicine,Rayan Hospital,RYN_IP,,,,1155629579,26-03-2024,2.1,-2.1,8546104.0,PCS,Issue to Patient,1.0,1.58003,-1.58003,750.0,1185.02379
6590020029,MAGNESIUM SULPHATE 50% INJ -5ML,Medicine,Rayan Hospital,RYN_IP,,,,1155629584,26-03-2024,2.1,-2.1,8546103.0,PCS,Issue to Patient,1.0,1.58003,-1.58003,749.0,1183.44376
6590020029,MAGNESIUM SULPHATE 50% INJ -5ML,Medicine,Rayan Hospital,RYN_IP,,,,1155633069,26-03-2024,2.1,-2.1,8546103.0,PCS,Issue to Patient,1.0,1.58003,-1.58003,748.0,1181.86373
6590020029,MAGNESIUM SULPHATE 50% INJ -5ML,Medicine,Rayan Hospital,RYN_IP,,,,1155633099,26-03-2024,2.1,-2.1,8546103.0,PCS,Issue to Patient,1.0,1.58003,-1.58003,747.0,1180.28369
6590020029,MAGNESIUM SULPHATE 50% INJ -5ML,Medicine,Rayan Hospital,RYN_IP,,,,1155727486,26-03-2024,2.1,-2.1,8546103.0,PCS,Issue to Patient,1.0,1.58003,-1.58003,746.0,1178.70366
6590020029,MAGNESIUM SULPHATE 50% INJ -5ML,Medicine,Rayan Hospital,RYN_IP,,,,1156017025,27-03-2024,2.1,-2.1,8546104.0,PCS,Issue to Patient,1.0,1.5801,-1.5801,845.0,1335.1804
6590020029,MAGNESIUM SULPHATE 50% INJ -5ML,Medicine,Rayan Hospital,RYN_IP,,,,1156086955,27-03-2024,2.1,-2.1,8546103.0,PCS,Issue to Patient,1.0,1.5801,-1.5801,844.0,1333.6003
6590020029,MAGNESIUM SULPHATE 50% INJ -5ML,Medicine,Rayan Hospital,RYN_IP,,,,1156107902,27-03-2024,2.1,-2.1,8546104.0,PCS,Issue to Patient,1.0,1.5801,-1.5801,843.0,1332.02021
6590020029,MAGNESIUM SULPHATE 50% INJ -5ML,Medicine,Rayan Hospital,RYN_IP,,,,1156112841,27-03-2024,2.1,-2.1,8546103.0,PCS,Issue to Patient,1.0,1.5801,-1.5801,842.0,1330.44011
6590020029,MAGNESIUM SULPHATE 50% INJ -5ML,Medicine,Rayan Hospital,STAGE,Rayan Hospital Clinics,RAY_ER,17533297,1156137558,27-03-2024,2.1,-10.5,8546104.0,PCS,Int Order Direct Ship,5.0,1.5801,-7.90048,837.0,1322.53964
6590020029,MAGNESIUM SULPHATE 50% INJ -5ML,Medicine,Rayan Hospital,RYN_IP,,,,1156159090,27-03-2024,2.1,-2.1,8546104.0,PCS,Issue to Patient,1.0,1.5801,-1.5801,836.0,1320.95954
6590020029,MAGNESIUM SULPHATE 50% INJ -5ML,Medicine,Rayan Hospital,RYN_IP,,,,1156220188,27-03-2024,2.1,-2.1,8546103.0,PCS,Issue to Patient,1.0,1.5801,-1.5801,835.0,1319.37945
6590020029,MAGNESIUM SULPHATE 50% INJ -5ML,Medicine,Rayan Hospital,RYN_IP,,,,1156220223,27-03-2024,2.1,-2.1,8546103.0,PCS,Issue to Patient,1.0,1.5801,-1.5801,834.0,1317.79935
6590020029,MAGNESIUM SULPHATE 50% INJ -5ML,Medicine,Rayan Hospital,RYN_IP,,,,1156221066,27-03-2024,2.1,-2.1,8546103.0,PCS,Issue to Patient,1.0,1.5801,-1.5801,833.0,1316.21926
6590020029,MAGNESIUM SULPHATE 50% INJ -5ML,Medicine,Rayan Hospital,RYN_IP,,,,1156222810,27-03-2024,2.1,-2.1,8546103.0,PCS,Issue to Patient,1.0,1.5801,-1.5801,832.0,1314.63916
6590020029,MAGNESIUM SULPHATE 50% INJ -5ML,Medicine,Rayan Hospital,RYN_IP,,,,1156268284,27-03-2024,2.1,-2.1,8546104.0,PCS,Issue to Patient,1.0,1.5801,-1.5801,831.0,1313.05907
6590020029,MAGNESIUM SULPHATE 50% INJ -5ML,Medicine,Rayan Hospital,RYN_IP,,,,1156688865,28-03-2024,2.1,-2.1,8546104.0,PCS,Issue to Patient,1.0,1.5801,-1.5801,830.0,1311.47897
6590020029,MAGNESIUM SULPHATE 50% INJ -5ML,Medicine,Rayan Hospital,RYN_IP,,,,1156712975,28-03-2024,2.1,-4.2,8546104.0,PCS,Issue to Patient,2.0,1.5801,-3.16019,828.0,1308.31878
6590020029,MAGNESIUM SULPHATE 50% INJ -5ML,Medicine,Rayan Hospital,RYN_IP,,,,1156827619,28-03-2024,2.1,-2.1,8546103.0,PCS,Issue to Patient,1.0,1.5801,-1.5801,827.0,1306.73869
6590020029,MAGNESIUM SULPHATE 50% INJ -5ML,Medicine,Rayan Hospital,RYN_IP,,,,1156827629,28-03-2024,2.1,-2.1,8546103.0,PCS,Issue to Patient,1.0,1.5801,-1.5801,826.0,1305.15859
6590020029,MAGNESIUM SULPHATE 50% INJ -5ML,Medicine,Rayan Hospital,RYN_IP,,,,1156836476,28-03-2024,2.1,-2.1,8546103.0,PCS,Issue to Patient,1.0,1.5801,-1.5801,825.0,1303.5785
6590020029,MAGNESIUM SULPHATE 50% INJ -5ML,Medicine,Rayan Hospital,RYN_IP,,,,1156836498,28-03-2024,2.1,-2.1,8546103.0,PCS,Issue to Patient,1.0,1.5801,-1.5801,824.0,1301.9984
6590020029,MAGNESIUM SULPHATE 50% INJ -5ML,Medicine,Rayan Hospital,RYN_IP,,,,1156962317,28-03-2024,2.1,-4.2,8546104.0,PCS,Issue to Patient,2.0,1.5801,-3.16019,822.0,1298.83821
6590020029,MAGNESIUM SULPHATE 50% INJ -5ML,Medicine,Rayan Hospital,RYN_IP,,,,1156963824,28-03-2024,2.1,-2.1,8546104.0,PCS,Issue to Patient,1.0,1.5801,-1.5801,821.0,1297.25812
6590020029,MAGNESIUM SULPHATE 50% INJ -5ML,Medicine,Rayan Hospital,RYN_IP,,,,1156965418,28-03-2024,2.1,-2.1,8546104.0,PCS,Issue to Patient,1.0,1.5801,-1.5801,820.0,1295.67802
6590020029,MAGNESIUM SULPHATE 50% INJ -5ML,Medicine,Rayan Hospital,RYN_IP,,,,1157024770,28-03-2024,2.1,-2.1,8546103.0,PCS,Issue to Patient,1.0,1.5801,-1.5801,819.0,1294.09793
6590020029,MAGNESIUM SULPHATE 50% INJ -5ML,Medicine,Rayan Hospital,RYN_IP,,,,1157100393,29-03-2024,2.1,-8.4,8546104.0,PCS,Issue to Patient,4.0,1.5801,-6.32038,815.0,1287.77754
6590020029,MAGNESIUM SULPHATE 50% INJ -5ML,Medicine,Rayan Hospital,RYN_IP,,,,1157155887,29-03-2024,2.1,-2.1,8546103.0,PCS,Issue to Patient,1.0,1.5801,-1.5801,814.0,1286.19745
6590020029,MAGNESIUM SULPHATE 50% INJ -5ML,Medicine,Rayan Hospital,RYN_IP,,,,1157160043,29-03-2024,2.1,-2.1,8546103.0,PCS,Issue to Patient,1.0,1.5801,-1.5801,813.0,1284.61735
6590020029,MAGNESIUM SULPHATE 50% INJ -5ML,Medicine,Rayan Hospital,RYN_IP,,,,1157162213,29-03-2024,2.1,-2.1,8546103.0,PCS,Issue to Patient,1.0,1.5801,-1.5801,812.0,1283.03726
6590020029,MAGNESIUM SULPHATE 50% INJ -5ML,Medicine,Rayan Hospital,RYN_IP,,,,1157187542,29-03-2024,2.1,-4.2,8546103.0,PCS,Issue to Patient,2.0,1.5801,-3.16019,810.0,1279.87707
6590020029,MAGNESIUM SULPHATE 50% INJ -5ML,Medicine,Rayan Hospital,RYN_IP,,,,1157199490,29-03-2024,2.1,-4.2,8546104.0,PCS,Issue to Patient,2.0,1.5801,-3.16019,808.0,1276.71688
6590020029,MAGNESIUM SULPHATE 50% INJ -5ML,Medicine,Rayan Hospital,RYN_IP,,,,1157204476,29-03-2024,2.1,-4.2,8546103.0,PCS,Issue to Patient,2.0,1.5801,-3.16019,806.0,1273.55669
6590020029,MAGNESIUM SULPHATE 50% INJ -5ML,Medicine,Rayan Hospital,RYN_IP,,,,1157205814,29-03-2024,2.1,-2.1,8546111.0,PCS,Issue to Patient,1.0,1.5801,-1.5801,805.0,1271.97659
6590020029,MAGNESIUM SULPHATE 50% INJ -5ML,Medicine,Rayan Hospital,RYN_IP,,,,1157206211,29-03-2024,2.1,-2.1,8546103.0,PCS,Issue to Patient,1.0,1.5801,-1.5801,804.0,1270.3965
6590020029,MAGNESIUM SULPHATE 50% INJ -5ML,Medicine,Rayan Hospital,RYN_IP,,,,1157207018,29-03-2024,2.1,-2.1,8546106.0,PCS,Issue to Patient,1.0,1.5801,-1.5801,803.0,1268.8164
6590020029,MAGNESIUM SULPHATE 50% INJ -5ML,Medicine,Rayan Hospital,RYN_IP,,,,1157207868,29-03-2024,2.1,-2.1,8546111.0,PCS,Issue to Patient,1.0,1.5801,-1.5801,802.0,1267.23631
6590020029,MAGNESIUM SULPHATE 50% INJ -5ML,Medicine,Rayan Hospital,RYN_IP,,,,1157207923,29-03-2024,2.1,-2.1,8546111.0,PCS,Issue to Patient,1.0,1.5801,-1.5801,801.0,1265.65621
6590020029,MAGNESIUM SULPHATE 50% INJ -5ML,Medicine,Rayan Hospital,RYN_IP,,,,1157208254,29-03-2024,2.1,-4.2,8546104.0,PCS,Issue to Patient,2.0,1.5801,-3.16019,799.0,1262.49602
6590020029,MAGNESIUM SULPHATE 50% INJ -5ML,Medicine,Rayan Hospital,RYN_IP,,,,1157220007,29-03-2024,2.1,-4.2,8546104.0,PCS,Issue to Patient,2.0,1.5801,-3.16019,797.0,1259.33583
6590020029,MAGNESIUM SULPHATE 50% INJ -5ML,Medicine,Rayan Hospital,RYN_IP,,,,1157225872,29-03-2024,2.1,-2.1,8546103.0,PCS,Issue to Patient,1.0,1.5801,-1.5801,796.0,1257.75574
6590020029,MAGNESIUM SULPHATE 50% INJ -5ML,Medicine,Rayan Hospital,RYN_IP,,,,1157227796,29-03-2024,2.1,-4.2,8546103.0,PCS,Issue to Patient,2.0,1.5801,-3.16019,794.0,1254.59555
6590020029,MAGNESIUM SULPHATE 50% INJ -5ML,Medicine,Rayan Hospital,RYN_IP,,,,1157248032,29-03-2024,2.1,-2.1,8546104.0,PCS,Issue to Patient,1.0,1.5801,-1.5801,793.0,1253.01545
6590020029,MAGNESIUM SULPHATE 50% INJ -5ML,Medicine,Rayan Hospital,RYN_IP,,,,1157260843,29-03-2024,2.1,-4.2,8546104.0,PCS,Issue to Patient,2.0,1.5801,-3.16019,791.0,1249.85526
6590020029,MAGNESIUM SULPHATE 50% INJ -5ML,Medicine,Rayan Hospital,RYN_IP,,,,1157336922,30-03-2024,2.1,-2.1,8546103.0,PCS,Issue to Patient,1.0,1.5801,-1.5801,790.0,1248.27517
6590020029,MAGNESIUM SULPHATE 50% INJ -5ML,Medicine,Rayan Hospital,RYN_IP,,,,1157343947,30-03-2024,2.1,-4.2,8546103.0,PCS,Issue to Patient,2.0,1.5801,-3.16019,788.0,1245.11498
6590020029,MAGNESIUM SULPHATE 50% INJ -5ML,Medicine,Rayan Hospital,RYN_IP,,,,1157397504,30-03-2024,2.1,-8.4,8546104.0,PCS,Issue to Patient,4.0,1.5801,-6.32038,784.0,1238.7946
6590020029,MAGNESIUM SULPHATE 50% INJ -5ML,Medicine,Rayan Hospital,RYN_IP,,,,1157397788,30-03-2024,2.1,-4.2,8546103.0,PCS,Issue to Patient,2.0,1.5801,-3.16019,782.0,1235.6344
6590020029,MAGNESIUM SULPHATE 50% INJ -5ML,Medicine,Rayan Hospital,RYN_IP,,,,1157403458,30-03-2024,2.1,-4.2,8546103.0,PCS,Issue to Patient,2.0,1.5801,-3.16019,780.0,1232.47421
6590020029,MAGNESIUM SULPHATE 50% INJ -5ML,Medicine,Rayan Hospital,RYN_IP,,,,1157407875,30-03-2024,2.1,-2.1,8546104.0,PCS,Issue to Patient,1.0,1.5801,-1.5801,781.0,1234.05431
6590020029,MAGNESIUM SULPHATE 50% INJ -5ML,Medicine,Rayan Hospital,RYN_IP,,,,1157408306,30-03-2024,2.1,-4.2,8546104.0,PCS,Issue to Patient,2.0,1.5801,-3.16019,779.0,1230.89412
6590020029,MAGNESIUM SULPHATE 50% INJ -5ML,Medicine,Rayan Hospital,RYN_IP,,,,1157408321,30-03-2024,2.1,-2.1,8546104.0,PCS,Issue to Patient,1.0,1.5801,-1.5801,778.0,1229.31402
6590020029,MAGNESIUM SULPHATE 50% INJ -5ML,Medicine,Rayan Hospital,RYN_IP,,,,1157415905,30-03-2024,2.1,-2.1,8546103.0,PCS,Issue to Patient,1.0,1.5801,-1.5801,777.0,1227.73393
6590020029,MAGNESIUM SULPHATE 50% INJ -5ML,Medicine,Rayan Hospital,RYN_IP,,,,1157423574,30-03-2024,2.1,-2.1,8546104.0,PCS,Issue to Patient,1.0,1.5801,-1.5801,776.0,1226.15383
6590020029,MAGNESIUM SULPHATE 50% INJ -5ML,Medicine,Rayan Hospital,RYN_IP,,,,1157454844,30-03-2024,2.1,-2.1,8546103.0,PCS,Issue to Patient,1.0,1.5801,-1.5801,775.0,1224.57374
6590020029,MAGNESIUM SULPHATE 50% INJ -5ML,Medicine,Rayan Hospital,RYN_IP,,,,1157455000,30-03-2024,2.1,-2.1,8546103.0,PCS,Issue to Patient,1.0,1.5801,-1.5801,774.0,1222.99364
6590020029,MAGNESIUM SULPHATE 50% INJ -5ML,Medicine,Rayan Hospital,RYN_IP,,,,1157480033,30-03-2024,2.1,-2.1,8546111.0,PCS,Issue to Patient,1.0,1.5801,-1.5801,773.0,1221.41355
6590020029,MAGNESIUM SULPHATE 50% INJ -5ML,Medicine,Rayan Hospital,RYN_IP,,,,1157482079,30-03-2024,2.1,-2.1,8546103.0,PCS,Issue to Patient,1.0,1.5801,-1.5801,772.0,1219.83345
6590020029,MAGNESIUM SULPHATE 50% INJ -5ML,Medicine,Rayan Hospital,RYN_IP,,,,1157482201,30-03-2024,2.1,-2.1,8546103.0,PCS,Issue to Patient,1.0,1.5801,-1.5801,771.0,1218.25336
6590020029,MAGNESIUM SULPHATE 50% INJ -5ML,Medicine,Rayan Hospital,RYN_IP,,,,1157862850,31-03-2024,2.1,-2.1,8546104.0,PCS,Issue to Patient,1.0,1.5801,-1.5801,770.0,1216.67326
6590020029,MAGNESIUM SULPHATE 50% INJ -5ML,Medicine,Rayan Hospital,RYN_IP,,,,1157866073,31-03-2024,2.1,-2.1,8546104.0,PCS,Issue to Patient,1.0,1.5801,-1.5801,769.0,1215.09317
6590020029,MAGNESIUM SULPHATE 50% INJ -5ML,Medicine,Rayan Hospital,RYN_IP,,,,1157888309,31-03-2024,2.1,-2.1,8546104.0,PCS,Issue to Patient,1.0,1.5801,-1.5801,768.0,1213.51307
6590020029,MAGNESIUM SULPHATE 50% INJ -5ML,Medicine,Rayan Hospital,RYN_IP,,,,1157891647,31-03-2024,2.1,-2.1,8546104.0,PCS,Issue to Patient,1.0,1.5801,-1.5801,767.0,1211.93298
6590020029,MAGNESIUM SULPHATE 50% INJ -5ML,Medicine,Rayan Hospital,RYN_IP,,,,1157892438,31-03-2024,2.1,-2.1,8546103.0,PCS,Issue to Patient,1.0,1.5801,-1.5801,766.0,1210.35288
6590020029,MAGNESIUM SULPHATE 50% INJ -5ML,Medicine,Rayan Hospital,RYN_IP,,,,1157931802,31-03-2024,2.1,-4.2,8546104.0,PCS,Issue to Patient,2.0,1.5801,-3.16019,764.0,1207.19269
6590020029,MAGNESIUM SULPHATE 50% INJ -5ML,Medicine,Rayan Hospital,RYN_IP,,,,1157934226,31-03-2024,2.1,-2.1,8546103.0,PCS,Issue to Patient,1.0,1.5801,-1.5801,763.0,1205.6126
6590020029,MAGNESIUM SULPHATE 50% INJ -5ML,Medicine,Rayan Hospital,RYN_IP,,,,1157966856,31-03-2024,2.1,-4.2,8546103.0,PCS,Issue to Patient,2.0,1.5801,-3.16019,761.0,1202.45241
6590020029,MAGNESIUM SULPHATE 50% INJ -5ML,Medicine,Rayan Hospital,RYN_IP,,,,1157967598,31-03-2024,2.1,-4.2,8546104.0,PCS,Issue to Patient,2.0,1.5801,-3.16019,759.0,1199.29222
6590020029,MAGNESIUM SULPHATE 50% INJ -5ML,Medicine,Rayan Hospital,RYN_IP,,,,1157973722,31-03-2024,2.1,-2.1,8546111.0,PCS,Issue to Patient,1.0,1.5801,-1.5801,758.0,1197.71212
6590020029,MAGNESIUM SULPHATE 50% INJ -5ML,Medicine,Rayan Hospital,RYN_IP,,,,1157977232,31-03-2024,2.1,-2.1,8546111.0,PCS,Issue to Patient,1.0,1.5801,-1.5801,757.0,1196.13203
6590020029,MAGNESIUM SULPHATE 50% INJ -5ML,Medicine,Rayan Hospital,RYN_IP,,,,1157977689,31-03-2024,2.1,-2.1,8546111.0,PCS,Issue to Patient,1.0,1.5801,-1.5801,756.0,1194.55193
6590020029,MAGNESIUM SULPHATE 50% INJ -5ML,Medicine,Rayan Hospital,RYN_IP,,,,1157979147,31-03-2024,2.1,-2.1,8546111.0,PCS,Issue to Patient,1.0,1.5801,-1.5801,755.0,1192.97184
6590020029,MAGNESIUM SULPHATE 50% INJ -5ML,Medicine,Rayan Hospital,RYN_IP,,,,1158062385,31-03-2024,2.1,-4.2,8546103.0,PCS,Issue to Patient,2.0,1.5801,-3.16019,753.0,1189.81165
6590020029,MAGNESIUM SULPHATE 50% INJ -5ML,Medicine,Rayan Hospital,RYN_IP,,,,1158378185,01-04-2024,2.1,-2.1,8546104.0,PCS,Issue to Patient,1.0,1.5801,-1.5801,752.0,1188.23155
6590020029,MAGNESIUM SULPHATE 50% INJ -5ML,Medicine,Rayan Hospital,RYN_IP,,,,1158425931,01-04-2024,2.1,-2.1,8546104.0,PCS,Issue to Patient,1.0,1.5801,-1.5801,751.0,1186.65146
6590020029,MAGNESIUM SULPHATE 50% INJ -5ML,Medicine,Rayan Hospital,RYN_IP,,,,1158440020,01-04-2024,2.1,-2.1,8546103.0,PCS,Issue to Patient,1.0,1.5801,-1.5801,750.0,1185.07136
6590020029,MAGNESIUM SULPHATE 50% INJ -5ML,Medicine,Rayan Hospital,RYN_IP,,,,1158452059,01-04-2024,2.1,-4.2,8546104.0,PCS,Issue to Patient,2.0,1.5801,-3.16019,748.0,1181.91117
6590020029,MAGNESIUM SULPHATE 50% INJ -5ML,Medicine,Rayan Hospital,RYN_IP,,,,1158513159,01-04-2024,2.1,-4.2,8546103.0,PCS,Issue to Patient,2.0,1.5801,-3.16019,746.0,1178.75098
6590020029,MAGNESIUM SULPHATE 50% INJ -5ML,Medicine,Rayan Hospital,RYN_IP,,,,1158530571,01-04-2024,2.1,-2.1,8546103.0,PCS,Issue to Patient,1.0,1.5801,-1.5801,745.0,1177.17088
6590020029,MAGNESIUM SULPHATE 50% INJ -5ML,Medicine,Rayan Hospital,RYN_IP,,,,1158533093,01-04-2024,2.1,-2.1,8546103.0,PCS,Issue to Patient,1.0,1.5801,-1.5801,744.0,1175.59079
6590020029,MAGNESIUM SULPHATE 50% INJ -5ML,Medicine,Rayan Hospital,RYN_IP,,,,1158641040,01-04-2024,2.1,-4.2,8546104.0,PCS,Issue to Patient,2.0,1.5801,-3.16019,742.0,1172.4306
6590020029,MAGNESIUM SULPHATE 50% INJ -5ML,Medicine,Rayan Hospital,RYN_IP,,,,1158899425,02-04-2024,2.1,-2.1,8546103.0,PCS,Issue to Patient,1.0,1.5801,-1.5801,741.0,1170.8505
6590020029,MAGNESIUM SULPHATE 50% INJ -5ML,Medicine,Rayan Hospital,RYN_IP,,,,1158924175,02-04-2024,2.1,-2.1,8546103.0,PCS,Issue to Patient,1.0,1.5801,-1.5801,740.0,1169.27041
6590020029,MAGNESIUM SULPHATE 50% INJ -5ML,Medicine,Rayan Hospital,RYN_IP,,,,1158936015,02-04-2024,2.1,-2.1,8546103.0,PCS,Issue to Patient,1.0,1.5801,-1.5801,739.0,1167.69031
6590020029,MAGNESIUM SULPHATE 50% INJ -5ML,Medicine,Rayan Hospital,RYN_IP,,,,1158941166,02-04-2024,2.1,-4.2,8546104.0,PCS,Issue to Patient,2.0,1.5801,-3.16019,737.0,1164.53012
6590020029,MAGNESIUM SULPHATE 50% INJ -5ML,Medicine,Rayan Hospital,RYN_IP,,,,1158943582,02-04-2024,2.1,-4.2,8546103.0,PCS,Issue to Patient,2.0,1.5801,-3.16019,735.0,1161.36993
6590020029,MAGNESIUM SULPHATE 50% INJ -5ML,Medicine,Rayan Hospital,RYN_IP,,,,1158951163,02-04-2024,2.1,-4.2,8546104.0,PCS,Issue to Patient,2.0,1.5801,-3.16019,733.0,1158.20974
6590020029,MAGNESIUM SULPHATE 50% INJ -5ML,Medicine,Rayan Hospital,RYN_IP,,,,1158966743,02-04-2024,2.1,-4.2,8546103.0,PCS,Issue to Patient,2.0,1.5801,-3.16019,731.0,1155.04955
6590020029,MAGNESIUM SULPHATE 50% INJ -5ML,Medicine,Rayan Hospital,RYN_IP,,,,1159009935,02-04-2024,2.1,-2.1,8546103.0,PCS,Issue to Patient,1.0,1.5801,-1.5801,730.0,1153.46946
6590020029,MAGNESIUM SULPHATE 50% INJ -5ML,Medicine,Rayan Hospital,RYN_IP,,,,1159009950,02-04-2024,2.1,-2.1,8546104.0,PCS,Issue to Patient,1.0,1.5801,-1.5801,729.0,1151.88936
6590020029,MAGNESIUM SULPHATE 50% INJ -5ML,Medicine,Rayan Hospital,RYN_IP,,,,1159010333,02-04-2024,2.1,-2.1,8546103.0,PCS,Issue to Patient,1.0,1.5801,-1.5801,728.0,1150.30927
6590020029,MAGNESIUM SULPHATE 50% INJ -5ML,Medicine,Rayan Hospital,RYN_IP,,,,1159027129,02-04-2024,2.1,-2.1,8546111.0,PCS,Issue to Patient,1.0,1.5801,-1.5801,727.0,1148.72917
6590020029,MAGNESIUM SULPHATE 50% INJ -5ML,Medicine,Rayan Hospital,RYN_IP,,,,1159030986,02-04-2024,2.1,-2.1,8546103.0,PCS,Issue to Patient,1.0,1.5801,-1.5801,726.0,1147.14908
6590020029,MAGNESIUM SULPHATE 50% INJ -5ML,Medicine,Rayan Hospital,RYN_IP,Rayan Main Pharmacy,RYN_MP,RAY28651,1159107393,02-04-2024,2.1,-73.5,8546103.0,PCS,Intransit Shipment,35.0,1.5801,-55.30333,691.0,1091.84575
6590020029,MAGNESIUM SULPHATE 50% INJ -5ML,Medicine,Rayan Hospital,RYN_IP,,,,1159319968,03-04-2024,2.1,-2.1,8546104.0,PCS,Issue to Patient,1.0,1.5801,-1.5801,690.0,1090.26565
6590020029,MAGNESIUM SULPHATE 50% INJ -5ML,Medicine,Rayan Hospital,RYN_IP,,,,1159365374,03-04-2024,2.1,-2.1,8546103.0,PCS,Issue to Patient,1.0,1.5801,-1.5801,689.0,1088.68556
6590020029,MAGNESIUM SULPHATE 50% INJ -5ML,Medicine,Rayan Hospital,RYN_IP,,,,1159399688,03-04-2024,2.1,-4.2,8546103.0,PCS,Issue to Patient,2.0,1.5801,-3.16019,688.0,1087.10546
6590020029,MAGNESIUM SULPHATE 50% INJ -5ML,Medicine,Rayan Hospital,RYN_IP,,,,1159423879,03-04-2024,2.1,-4.2,8546104.0,PCS,Issue to Patient,2.0,1.5801,-3.16019,686.0,1083.94527
6590020029,MAGNESIUM SULPHATE 50% INJ -5ML,Medicine,Rayan Hospital,RYN_IP,,,,1159436696,03-04-2024,2.1,-4.2,8546104.0,PCS,Issue to Patient,2.0,1.5801,-3.16019,684.0,1080.78508
6590020029,MAGNESIUM SULPHATE 50% INJ -5ML,Medicine,Rayan Hospital,RYN_IP,,,,1159497548,03-04-2024,2.1,-8.4,8546104.0,PCS,Issue to Patient,4.0,1.5801,-6.32038,680.0,1074.4647
6590020029,MAGNESIUM SULPHATE 50% INJ -5ML,Medicine,Rayan Hospital,RYN_IP,,,,1159503501,03-04-2024,2.1,-2.1,8546111.0,PCS,Issue to Patient,1.0,1.5801,-1.5801,679.0,1072.8846
6590020029,MAGNESIUM SULPHATE 50% INJ -5ML,Medicine,Rayan Hospital,RYN_IP,,,,1159503756,03-04-2024,2.1,-2.1,8546111.0,PCS,Issue to Patient,1.0,1.5801,-1.5801,678.0,1071.30451
6590020029,MAGNESIUM SULPHATE 50% INJ -5ML,Medicine,Rayan Hospital,RYN_IP,,,,1159507663,03-04-2024,2.1,-2.1,8546111.0,PCS,Issue to Patient,1.0,1.5801,-1.5801,677.0,1069.72441
6590020029,MAGNESIUM SULPHATE 50% INJ -5ML,Medicine,Rayan Hospital,RYN_IP,,,,1159508126,03-04-2024,2.1,-2.1,8546111.0,PCS,Issue to Patient,1.0,1.5801,-1.5801,676.0,1068.14432
6590020029,MAGNESIUM SULPHATE 50% INJ -5ML,Medicine,Rayan Hospital,RYN_IP,,,,1159547317,03-04-2024,2.1,-4.2,8546104.0,PCS,Issue to Patient,2.0,1.5801,-3.16019,674.0,1064.98413
6590020029,MAGNESIUM SULPHATE 50% INJ -5ML,Medicine,Rayan Hospital,RYN_IP,,,,1159608493,03-04-2024,2.1,-4.2,8546104.0,PCS,Issue to Patient,2.0,1.5801,-3.16019,672.0,1061.82394
6590020029,MAGNESIUM SULPHATE 50% INJ -5ML,Medicine,Rayan Hospital,RYN_IP,,,,1159630719,03-04-2024,2.1,-8.4,8546104.0,PCS,Issue to Patient,4.0,1.5801,-6.32038,668.0,1055.50356
6590020029,MAGNESIUM SULPHATE 50% INJ -5ML,Medicine,Rayan Hospital,RYN_IP,,,,1159740190,03-04-2024,2.1,-8.4,8546104.0,PCS,Issue to Patient,4.0,1.5801,-6.32038,664.0,1049.18318
6590020029,MAGNESIUM SULPHATE 50% INJ -5ML,Medicine,Rayan Hospital,RYN_IP,,,,1159804052,04-04-2024,2.1,-4.2,8546104.0,PCS,Issue to Patient,2.0,1.5801,-3.16019,662.0,1046.02299
6590020029,MAGNESIUM SULPHATE 50% INJ -5ML,Medicine,Rayan Hospital,RYN_IP,,,,1159841855,04-04-2024,2.1,-2.1,8546103.0,PCS,Issue to Patient,1.0,1.5801,-1.5801,661.0,1044.44289
6590020029,MAGNESIUM SULPHATE 50% INJ -5ML,Medicine,Rayan Hospital,RYN_IP,,,,1159851826,04-04-2024,2.1,-2.1,8546104.0,PCS,Issue to Patient,1.0,1.5801,-1.5801,661.0,1044.44289
6590020029,MAGNESIUM SULPHATE 50% INJ -5ML,Medicine,Rayan Hospital,RYN_IP,,,,1159860769,04-04-2024,2.1,-8.4,8546104.0,PCS,Issue to Patient,4.0,1.5801,-6.32038,657.0,1038.12251
6590020029,MAGNESIUM SULPHATE 50% INJ -5ML,Medicine,Rayan Hospital,RYN_IP,,,,1159872056,04-04-2024,2.1,-4.2,8546104.0,PCS,Issue to Patient,2.0,1.5801,-3.16019,655.0,1034.96232
6590020029,MAGNESIUM SULPHATE 50% INJ -5ML,Medicine,Rayan Hospital,RYN_IP,,,,1159890569,04-04-2024,2.1,-4.2,8546104.0,PCS,Issue to Patient,2.0,1.5801,-3.16019,653.0,1031.80213
6590020029,MAGNESIUM SULPHATE 50% INJ -5ML,Medicine,Rayan Hospital,RYN_IP,,,,1159893043,04-04-2024,2.1,-4.2,8546104.0,PCS,Issue to Patient,2.0,1.5801,-3.16019,651.0,1028.64194
6590020029,MAGNESIUM SULPHATE 50% INJ -5ML,Medicine,Rayan Hospital,RYN_IP,,,,1159902563,04-04-2024,2.1,-4.2,8546104.0,PCS,Issue to Patient,2.0,1.5801,-3.16019,649.0,1025.48175
6590020029,MAGNESIUM SULPHATE 50% INJ -5ML,Medicine,Rayan Hospital,RYN_IP,,,,1159902588,04-04-2024,2.1,-4.2,8546104.0,PCS,Issue to Patient,2.0,1.5801,-3.16019,647.0,1022.32156
6590020029,MAGNESIUM SULPHATE 50% INJ -5ML,Medicine,Rayan Hospital,RYN_IP,,,,1159903145,04-04-2024,2.1,-2.1,8546104.0,PCS,Issue to Patient,1.0,1.5801,-1.5801,646.0,1020.74146
6590020029,MAGNESIUM SULPHATE 50% INJ -5ML,Medicine,Rayan Hospital,RYN_IP,,,,1159951119,04-04-2024,2.1,-8.4,8546104.0,PCS,Issue to Patient,4.0,1.5801,-6.32038,642.0,1014.42108
6590020029,MAGNESIUM SULPHATE 50% INJ -5ML,Medicine,Rayan Hospital,RYN_IP,,,,1159964656,04-04-2024,2.1,-2.1,8546111.0,PCS,Issue to Patient,1.0,1.5801,-1.5801,641.0,1012.84099
6590020029,MAGNESIUM SULPHATE 50% INJ -5ML,Medicine,Rayan Hospital,RYN_IP,,,,1159965974,04-04-2024,2.1,-2.1,8546111.0,PCS,Issue to Patient,1.0,1.5801,-1.5801,640.0,1011.26089
6590020029,MAGNESIUM SULPHATE 50% INJ -5ML,Medicine,Rayan Hospital,RYN_IP,,,,1159968650,04-04-2024,2.1,-2.1,8546111.0,PCS,Issue to Patient,1.0,1.5801,-1.5801,639.0,1009.6808
6590020029,MAGNESIUM SULPHATE 50% INJ -5ML,Medicine,Rayan Hospital,RYN_IP,,,,1159971259,04-04-2024,2.1,-2.1,8546111.0,PCS,Issue to Patient,1.0,1.5801,-1.5801,638.0,1008.1007
6590020029,MAGNESIUM SULPHATE 50% INJ -5ML,Medicine,Rayan Hospital,RYN_IP,,,,1159972847,04-04-2024,2.1,-2.1,8546111.0,PCS,Issue to Patient,1.0,1.5801,-1.5801,637.0,1006.52061
6590020029,MAGNESIUM SULPHATE 50% INJ -5ML,Medicine,Rayan Hospital,RYN_IP,,,,1160013962,04-04-2024,2.1,-2.1,8546103.0,PCS,Issue to Patient,1.0,1.5801,-1.5801,636.0,1004.94051
6590020029,MAGNESIUM SULPHATE 50% INJ -5ML,Medicine,Rayan Hospital,RYN_IP,,,,1160097126,04-04-2024,2.1,-8.4,8546103.0,PCS,Issue to Patient,4.0,1.5801,-6.32038,632.0,998.62013
6590020029,MAGNESIUM SULPHATE 50% INJ -5ML,Medicine,Rayan Hospital,RYN_IP,,,,1160136038,04-04-2024,2.1,-4.2,8546103.0,PCS,Issue to Patient,2.0,1.5801,-3.16019,630.0,995.45994
6590020029,MAGNESIUM SULPHATE 50% INJ -5ML,Medicine,Rayan Hospital,RYN_IP,,,,1160136778,04-04-2024,2.1,-8.4,8546104.0,PCS,Issue to Patient,4.0,1.5801,-6.32038,626.0,989.13956
6590020029,MAGNESIUM SULPHATE 50% INJ -5ML,Medicine,Rayan Hospital,RYN_IP,,,,1160282616,05-04-2024,2.1,-2.1,8546103.0,PCS,Issue to Patient,1.0,1.5801,-1.5801,625.0,987.55947
6590020029,MAGNESIUM SULPHATE 50% INJ -5ML,Medicine,Rayan Hospital,RYN_IP,,,,1160282621,05-04-2024,2.1,-4.2,8546104.0,PCS,Issue to Patient,2.0,1.5801,-3.16019,623.0,984.39928
6590020029,MAGNESIUM SULPHATE 50% INJ -5ML,Medicine,Rayan Hospital,RYN_IP,,,,1160323405,05-04-2024,2.1,-4.2,8546104.0,PCS,Issue to Patient,2.0,1.5801,-3.16019,621.0,981.23909
6590020029,MAGNESIUM SULPHATE 50% INJ -5ML,Medicine,Rayan Hospital,RYN_IP,,,,1160330431,05-04-2024,2.1,-4.2,8546103.0,PCS,Issue to Patient,2.0,1.5801,-3.16019,619.0,978.0789
6590020029,MAGNESIUM SULPHATE 50% INJ -5ML,Medicine,Rayan Hospital,RYN_IP,,,,1160357922,05-04-2024,2.1,-6.3,8546104.0,PCS,Issue to Patient,3.0,1.5801,-4.74029,616.0,973.33861
6590020029,MAGNESIUM SULPHATE 50% INJ -5ML,Medicine,Rayan Hospital,RYN_IP,,,,1160372005,05-04-2024,2.1,-2.1,8546111.0,PCS,Issue to Patient,1.0,1.5801,-1.5801,615.0,971.75852
6590020029,MAGNESIUM SULPHATE 50% INJ -5ML,Medicine,Rayan Hospital,RYN_IP,,,,1160378608,05-04-2024,2.1,-4.2,8546103.0,PCS,Issue to Patient,2.0,1.5801,-3.16019,613.0,968.59833
6590020029,MAGNESIUM SULPHATE 50% INJ -5ML,Medicine,Rayan Hospital,RYN_IP,,,,1160498687,06-04-2024,2.1,-6.3,8546103.0,PCS,Issue to Patient,3.0,1.5801,-4.74029,610.0,963.85804
6590020029,MAGNESIUM SULPHATE 50% INJ -5ML,Medicine,Rayan Hospital,STAGE,Rayan Hospital Clinics,RAY_ER,17536313,1160513873,06-04-2024,2.1,-4.2,8546104.0,PCS,Int Order Direct Ship,2.0,1.5801,-3.16019,608.0,960.69785
6590020029,MAGNESIUM SULPHATE 50% INJ -5ML,Medicine,Rayan Hospital,RYN_IP,,,,1160515313,06-04-2024,2.1,-2.1,8546104.0,PCS,Issue to Patient,1.0,1.5801,-1.5801,607.0,959.11775
6590020029,MAGNESIUM SULPHATE 50% INJ -5ML,Medicine,Rayan Hospital,RYN_IP,,,,1160520547,06-04-2024,2.1,-4.2,8546104.0,PCS,Issue to Patient,2.0,1.5801,-3.16019,605.0,955.95756
6590020029,MAGNESIUM SULPHATE 50% INJ -5ML,Medicine,Rayan Hospital,RYN_IP,,,,1160530102,06-04-2024,2.1,-4.2,8546103.0,PCS,Issue to Patient,2.0,1.5801,-3.16019,603.0,952.79737
6590020029,MAGNESIUM SULPHATE 50% INJ -5ML,Medicine,Rayan Hospital,RYN_IP,,,,1160535613,06-04-2024,2.1,-2.1,8546106.0,PCS,Issue to Patient,1.0,1.5801,-1.5801,602.0,951.21728
6590020029,MAGNESIUM SULPHATE 50% INJ -5ML,Medicine,Rayan Hospital,RYN_IP,,,,1160537142,06-04-2024,2.1,-4.2,8546104.0,PCS,Issue to Patient,2.0,1.5801,-3.16019,600.0,948.05709
6590020029,MAGNESIUM SULPHATE 50% INJ -5ML,Medicine,Rayan Hospital,RYN_IP,,,,1160538636,06-04-2024,2.1,-2.1,8546106.0,PCS,Issue to Patient,1.0,1.5801,-1.5801,599.0,946.47699
6590020029,MAGNESIUM SULPHATE 50% INJ -5ML,Medicine,Rayan Hospital,RYN_IP,,,,1160539965,06-04-2024,2.1,-4.2,8546103.0,PCS,Issue to Patient,2.0,1.5801,-3.16019,597.0,943.3168
6590020029,MAGNESIUM SULPHATE 50% INJ -5ML,Medicine,Rayan Hospital,RYN_IP,,,,1160688290,06-04-2024,2.1,-2.1,8546111.0,PCS,Issue to Patient,1.0,1.5801,-1.5801,596.0,941.73671
6590020029,MAGNESIUM SULPHATE 50% INJ -5ML,Medicine,Rayan Hospital,RYN_IP,,,,1160690566,06-04-2024,2.1,-2.1,8546111.0,PCS,Issue to Patient,1.0,1.5801,-1.5801,595.0,940.15661
6590020029,MAGNESIUM SULPHATE 50% INJ -5ML,Medicine,Rayan Hospital,RYN_IP,,,,1160690703,06-04-2024,2.1,-2.1,8546111.0,PCS,Issue to Patient,1.0,1.5801,-1.5801,594.0,938.57652
6590020029,MAGNESIUM SULPHATE 50% INJ -5ML,Medicine,Rayan Hospital,RYN_IP,,,,1160692761,06-04-2024,2.1,-2.1,8546111.0,PCS,Issue to Patient,1.0,1.5801,-1.5801,593.0,936.99642
6590020029,MAGNESIUM SULPHATE 50% INJ -5ML,Medicine,Rayan Hospital,RYN_IP,,,,1160692816,06-04-2024,2.1,-2.1,8546111.0,PCS,Issue to Patient,1.0,1.5801,-1.5801,592.0,935.41633
6590020029,MAGNESIUM SULPHATE 50% INJ -5ML,Medicine,Rayan Hospital,RYN_IP,,,,1160695891,06-04-2024,2.1,-2.1,8546111.0,PCS,Issue to Patient,1.0,1.5801,-1.5801,591.0,933.83623
6590020029,MAGNESIUM SULPHATE 50% INJ -5ML,Medicine,Rayan Hospital,RYN_IP,,,,1160709459,06-04-2024,2.1,-4.2,8546106.0,PCS,Issue to Patient,2.0,1.5801,-3.16019,589.0,930.67604
6590020029,MAGNESIUM SULPHATE 50% INJ -5ML,Medicine,Rayan Hospital,RYN_IP,,,,1160759381,06-04-2024,2.1,-4.2,8546104.0,PCS,Issue to Patient,2.0,1.5801,-3.16019,587.0,927.51585
6590020029,MAGNESIUM SULPHATE 50% INJ -5ML,Medicine,Rayan Hospital,RYN_IP,,,,1160945192,07-04-2024,2.1,-2.1,8546103.0,PCS,Issue to Patient,1.0,1.5801,-1.5801,586.0,925.93576
6590020029,MAGNESIUM SULPHATE 50% INJ -5ML,Medicine,Rayan Hospital,RYN_IP,,,,1160998548,07-04-2024,2.1,-4.2,8546106.0,PCS,Issue to Patient,2.0,1.5801,-3.16019,584.0,922.77557
6590020029,MAGNESIUM SULPHATE 50% INJ -5ML,Medicine,Rayan Hospital,RYN_IP,,,,1161007286,07-04-2024,2.1,-2.1,8546111.0,PCS,Issue to Patient,1.0,1.5801,-1.5801,583.0,921.19547
6590020029,MAGNESIUM SULPHATE 50% INJ -5ML,Medicine,Rayan Hospital,RYN_IP,,,,1161007466,07-04-2024,2.1,-2.1,8546103.0,PCS,Issue to Patient,1.0,1.5801,-1.5801,582.0,919.61538
6590020029,MAGNESIUM SULPHATE 50% INJ -5ML,Medicine,Rayan Hospital,RYN_IP,,,,1161009620,07-04-2024,2.1,-2.1,8546103.0,PCS,Issue to Patient,1.0,1.5801,-1.5801,581.0,918.03528
6590020029,MAGNESIUM SULPHATE 50% INJ -5ML,Medicine,Rayan Hospital,RYN_IP,,,,1161009736,07-04-2024,2.1,-2.1,8546103.0,PCS,Issue to Patient,1.0,1.5801,-1.5801,580.0,916.45519
6590020029,MAGNESIUM SULPHATE 50% INJ -5ML,Medicine,Rayan Hospital,RYN_IP,,,,1161009781,07-04-2024,2.1,-2.1,8546103.0,PCS,Issue to Patient,1.0,1.5801,-1.5801,579.0,914.87509
6590020029,MAGNESIUM SULPHATE 50% INJ -5ML,Medicine,Rayan Hospital,RYN_IP,,,,1161011825,07-04-2024,2.1,-2.1,8546103.0,PCS,Issue to Patient,1.0,1.5801,-1.5801,578.0,913.29499
6590020029,MAGNESIUM SULPHATE 50% INJ -5ML,Medicine,Rayan Hospital,RYN_IP,,,,1161044540,07-04-2024,2.1,-4.2,8546104.0,PCS,Issue to Patient,2.0,1.5801,-3.16019,576.0,910.1348
6590020029,MAGNESIUM SULPHATE 50% INJ -5ML,Medicine,Rayan Hospital,RYN_IP,,,,1161047344,07-04-2024,2.1,-4.2,8546106.0,PCS,Issue to Patient,2.0,1.5801,-3.16019,574.0,906.97461
6590020029,MAGNESIUM SULPHATE 50% INJ -5ML,Medicine,Rayan Hospital,RYN_IP,,,,1161061596,07-04-2024,2.1,-4.2,8546104.0,PCS,Issue to Patient,2.0,1.5801,-3.16019,572.0,903.81442
6590020029,MAGNESIUM SULPHATE 50% INJ -5ML,Medicine,Rayan Hospital,RYN_IP,,,,1161084806,07-04-2024,2.1,-4.2,8546106.0,PCS,Issue to Patient,2.0,1.5801,-3.16019,570.0,900.65423
6590020029,MAGNESIUM SULPHATE 50% INJ -5ML,Medicine,Rayan Hospital,RYN_IP,,,,1161162392,07-04-2024,2.1,-2.1,8546104.0,PCS,Issue to Patient,1.0,1.5801,-1.5801,569.0,899.07414
6590020029,MAGNESIUM SULPHATE 50% INJ -5ML,Medicine,Rayan Hospital,RYN_IP,,,,1161197605,07-04-2024,2.1,-4.2,8546104.0,PCS,Issue to Patient,2.0,1.5801,-3.16019,569.0,899.07414
6590020029,MAGNESIUM SULPHATE 50% INJ -5ML,Medicine,Rayan Hospital,RYN_IP,,,,1161282373,08-04-2024,2.1,-2.1,8546104.0,PCS,Issue to Patient,1.0,1.5801,-1.5801,568.0,897.49404
6590020029,MAGNESIUM SULPHATE 50% INJ -5ML,Medicine,Rayan Hospital,RYN_IP,,,,1161321584,08-04-2024,2.1,-2.1,8546103.0,PCS,Issue to Patient,1.0,1.5801,-1.5801,567.0,895.91395
6590020029,MAGNESIUM SULPHATE 50% INJ -5ML,Medicine,Rayan Hospital,RYN_IP,,,,1161323712,08-04-2024,2.1,-4.2,8546106.0,PCS,Issue to Patient,2.0,1.5801,-3.16019,565.0,892.75376
6590020029,MAGNESIUM SULPHATE 50% INJ -5ML,Medicine,Rayan Hospital,RYN_IP,,,,1161333141,08-04-2024,2.1,-8.4,8546104.0,PCS,Issue to Patient,4.0,1.5801,-6.32038,561.0,886.43338
6590020029,MAGNESIUM SULPHATE 50% INJ -5ML,Medicine,Rayan Hospital,RYN_IP,,,,1161340816,08-04-2024,2.1,-4.2,8546103.0,PCS,Issue to Patient,2.0,1.5801,-3.16019,559.0,883.27319
6590020029,MAGNESIUM SULPHATE 50% INJ -5ML,Medicine,Rayan Hospital,RYN_IP,,,,1161369936,08-04-2024,2.1,-2.1,8546106.0,PCS,Issue to Patient,1.0,1.5801,-1.5801,558.0,881.69309
6590020029,MAGNESIUM SULPHATE 50% INJ -5ML,Medicine,Rayan Hospital,RYN_IP,,,,1161385777,08-04-2024,2.1,-2.1,8546106.0,PCS,Issue to Patient,1.0,1.5801,-1.5801,557.0,880.113
6590020029,MAGNESIUM SULPHATE 50% INJ -5ML,Medicine,Rayan Hospital,STAGE,Rayan Hospital Clinics,RAY_ER,17540044,1161387599,08-04-2024,2.1,-6.3,8546104.0,PCS,Int Order Direct Ship,3.0,1.5801,-4.74029,554.0,875.37271
6590020029,MAGNESIUM SULPHATE 50% INJ -5ML,Medicine,Rayan Hospital,RYN_IP,,,,1161400274,08-04-2024,2.1,-4.2,8546103.0,PCS,Issue to Patient,2.0,1.5801,-3.16019,552.0,872.21252
6590020029,MAGNESIUM SULPHATE 50% INJ -5ML,Medicine,Rayan Hospital,RYN_IP,,,,1161451098,08-04-2024,2.1,-4.2,8546106.0,PCS,Issue to Patient,2.0,1.5801,-3.16019,550.0,869.05233
6590020029,MAGNESIUM SULPHATE 50% INJ -5ML,Medicine,Rayan Hospital,RYN_IP,,,,1161454346,08-04-2024,2.1,-2.1,8546106.0,PCS,Issue to Patient,1.0,1.5801,-1.5801,549.0,867.47224
6590020029,MAGNESIUM SULPHATE 50% INJ -5ML,Medicine,Rayan Hospital,RYN_IP,,,,1161454589,08-04-2024,2.1,-2.1,8546111.0,PCS,Issue to Patient,1.0,1.5801,-1.5801,548.0,865.89214
6590020029,MAGNESIUM SULPHATE 50% INJ -5ML,Medicine,Rayan Hospital,RYN_IP,,,,1161461178,08-04-2024,2.1,-2.1,8546111.0,PCS,Issue to Patient,1.0,1.5801,-1.5801,547.0,864.31205
6590020029,MAGNESIUM SULPHATE 50% INJ -5ML,Medicine,Rayan Hospital,RYN_IP,,,,1161463609,08-04-2024,2.1,-2.1,8546111.0,PCS,Issue to Patient,1.0,1.5801,-1.5801,546.0,862.73195
6590020029,MAGNESIUM SULPHATE 50% INJ -5ML,Medicine,Rayan Hospital,RYN_IP,,,,1161463715,08-04-2024,2.1,-8.4,8546103.0,PCS,Issue to Patient,4.0,1.5801,-6.32038,542.0,856.41157
6590020029,MAGNESIUM SULPHATE 50% INJ -5ML,Medicine,Rayan Hospital,RYN_IP,,,,1161465342,08-04-2024,2.1,-2.1,8546106.0,PCS,Issue to Patient,1.0,1.5801,-1.5801,541.0,854.83147
6590020029,MAGNESIUM SULPHATE 50% INJ -5ML,Medicine,Rayan Hospital,RYN_IP,,,,1161471678,08-04-2024,2.1,-8.4,8546106.0,PCS,Issue to Patient,4.0,1.5801,-6.32038,537.0,848.51109
6590020029,MAGNESIUM SULPHATE 50% INJ -5ML,Medicine,Rayan Hospital,RYN_IP,,,,1161483716,08-04-2024,2.1,-2.1,8546111.0,PCS,Issue to Patient,1.0,1.5801,-1.5801,536.0,846.931
6590020029,MAGNESIUM SULPHATE 50% INJ -5ML,Medicine,Rayan Hospital,RYN_IP,,,,1161488988,08-04-2024,2.1,-2.1,8546111.0,PCS,Issue to Patient,1.0,1.5801,-1.5801,539.0,851.67128
6590020029,MAGNESIUM SULPHATE 50% INJ -5ML,Medicine,Rayan Hospital,RYN_IP,,,,1161542576,08-04-2024,2.1,-2.1,8546106.0,PCS,Issue to Patient,1.0,1.5801,-1.5801,538.0,850.09119
6590020029,MAGNESIUM SULPHATE 50% INJ -5ML,Medicine,Rayan Hospital,RYN_IP,,,,1161552652,08-04-2024,2.1,-2.1,8546103.0,PCS,Issue to Patient,1.0,1.5801,-1.5801,537.0,848.51109
6590020029,MAGNESIUM SULPHATE 50% INJ -5ML,Medicine,Rayan Hospital,RYN_IP,,,,1161665640,09-04-2024,2.1,-2.1,8546106.0,PCS,Issue to Patient,1.0,1.5801,-1.5801,536.0,846.931
6590020029,MAGNESIUM SULPHATE 50% INJ -5ML,Medicine,Rayan Hospital,RYN_IP,,,,1161678275,09-04-2024,2.1,-2.1,8546103.0,PCS,Issue to Patient,1.0,1.5801,-1.5801,535.0,845.3509
6590020029,MAGNESIUM SULPHATE 50% INJ -5ML,Medicine,Rayan Hospital,RYN_IP,,,,1161690626,09-04-2024,2.1,-8.4,8546106.0,PCS,Issue to Patient,4.0,1.5801,-6.32038,531.0,839.03052
6590020029,MAGNESIUM SULPHATE 50% INJ -5ML,Medicine,Rayan Hospital,RYN_IP,,,,1161694009,09-04-2024,2.1,-4.2,8546103.0,PCS,Issue to Patient,2.0,1.5801,-3.16019,529.0,835.87033
6590020029,MAGNESIUM SULPHATE 50% INJ -5ML,Medicine,Rayan Hospital,RYN_IP,,,,1161704169,09-04-2024,2.1,-2.1,8546103.0,PCS,Issue to Patient,1.0,1.5801,-1.5801,528.0,834.29024
6590020029,MAGNESIUM SULPHATE 50% INJ -5ML,Medicine,Rayan Hospital,STAGE,Rayan Hospital Clinics,RAY_ER,17539397,1161720971,09-04-2024,2.1,-25.2,8546104.0,PCS,Int Order Direct Ship,12.0,1.5801,-18.96114,516.0,815.3291
6590020029,MAGNESIUM SULPHATE 50% INJ -5ML,Medicine,Rayan Hospital,RYN_IP,,,,1161728775,09-04-2024,2.1,-2.1,8546103.0,PCS,Issue to Patient,1.0,1.5801,-1.5801,519.0,820.06938
6590020029,MAGNESIUM SULPHATE 50% INJ -5ML,Medicine,Rayan Hospital,RYN_IP,,,,1161730933,09-04-2024,2.1,-4.2,8546106.0,PCS,Issue to Patient,2.0,1.5801,-3.16019,517.0,816.90919
6590020029,MAGNESIUM SULPHATE 50% INJ -5ML,Medicine,Rayan Hospital,RYN_IP,,,,1161770916,09-04-2024,2.1,-2.1,8546111.0,PCS,Issue to Patient,1.0,1.5801,-1.5801,516.0,815.3291
6590020029,MAGNESIUM SULPHATE 50% INJ -5ML,Medicine,Rayan Hospital,RYN_IP,,,,1161771849,09-04-2024,2.1,-2.1,8546111.0,PCS,Issue to Patient,1.0,1.5801,-1.5801,515.0,813.749
6590020029,MAGNESIUM SULPHATE 50% INJ -5ML,Medicine,Rayan Hospital,RYN_IP,,,,1161771859,09-04-2024,2.1,-2.1,8546111.0,PCS,Issue to Patient,1.0,1.5801,-1.5801,514.0,812.16891
6590020029,MAGNESIUM SULPHATE 50% INJ -5ML,Medicine,Rayan Hospital,RYN_IP,,,,1161771864,09-04-2024,2.1,-4.2,8546106.0,PCS,Issue to Patient,2.0,1.5801,-3.16019,512.0,809.00872
6590020029,MAGNESIUM SULPHATE 50% INJ -5ML,Medicine,Rayan Hospital,RYN_IP,,,,1161790534,09-04-2024,2.1,-4.2,8546106.0,PCS,Issue to Patient,2.0,1.5801,-3.16019,510.0,805.84852
6590020029,MAGNESIUM SULPHATE 50% INJ -5ML,Medicine,Rayan Hospital,RYN_IP,,,,1161810582,09-04-2024,2.1,-4.2,8546103.0,PCS,Issue to Patient,2.0,1.5801,-3.16019,508.0,802.68833
6590020029,MAGNESIUM SULPHATE 50% INJ -5ML,Medicine,Rayan Hospital,RYN_IP,,,,1161850875,10-04-2024,2.1,-6.3,8546106.0,PCS,Issue to Patient,3.0,1.5801,-4.74029,505.0,797.94805
6590020029,MAGNESIUM SULPHATE 50% INJ -5ML,Medicine,Rayan Hospital,RYN_IP,,,,1161859834,10-04-2024,2.1,-6.3,8546104.0,PCS,Issue to Patient,3.0,1.5801,-4.74029,505.0,797.94805
6590020029,MAGNESIUM SULPHATE 50% INJ -5ML,Medicine,Rayan Hospital,RYN_IP,,,,1161892513,10-04-2024,2.1,-2.1,8546106.0,PCS,Issue to Patient,1.0,1.5801,-1.5801,504.0,796.36795
6590020029,MAGNESIUM SULPHATE 50% INJ -5ML,Medicine,Rayan Hospital,RYN_IP,,,,1161892518,10-04-2024,2.1,-4.2,8546103.0,PCS,Issue to Patient,2.0,1.5801,-3.16019,502.0,793.20776
6590020029,MAGNESIUM SULPHATE 50% INJ -5ML,Medicine,Rayan Hospital,RYN_IP,,,,1161905739,10-04-2024,2.1,-4.2,8546106.0,PCS,Issue to Patient,2.0,1.5801,-3.16019,500.0,790.04757
6590020029,MAGNESIUM SULPHATE 50% INJ -5ML,Medicine,Rayan Hospital,RYN_IP,,,,1161916674,10-04-2024,2.1,-2.1,8546103.0,PCS,Issue to Patient,1.0,1.5801,-1.5801,499.0,788.46748
6590020029,MAGNESIUM SULPHATE 50% INJ -5ML,Medicine,Rayan Hospital,RYN_IP,,,,1161924109,10-04-2024,2.1,-4.2,8546106.0,PCS,Issue to Patient,2.0,1.5801,-3.16019,497.0,785.30729
6590020029,MAGNESIUM SULPHATE 50% INJ -5ML,Medicine,Rayan Hospital,RYN_IP,,,,1161975206,10-04-2024,2.1,-2.1,8546104.0,PCS,Issue to Patient,1.0,1.5801,-1.5801,496.0,783.72719
6590020029,MAGNESIUM SULPHATE 50% INJ -5ML,Medicine,Rayan Hospital,RYN_IP,,,,1161987824,11-04-2024,2.1,-2.1,8546104.0,PCS,Issue to Patient,1.0,1.5801,-1.5801,495.0,782.1471
6590020029,MAGNESIUM SULPHATE 50% INJ -5ML,Medicine,Rayan Hospital,RYN_IP,,,,1161988838,11-04-2024,2.1,-2.1,8546103.0,PCS,Issue to Patient,1.0,1.5801,-1.5801,494.0,780.567
6590020029,MAGNESIUM SULPHATE 50% INJ -5ML,Medicine,Rayan Hospital,RYN_IP,,,,1162037248,11-04-2024,2.1,-2.1,8546103.0,PCS,Issue to Patient,1.0,1.5801,-1.5801,493.0,778.98691
6590020029,MAGNESIUM SULPHATE 50% INJ -5ML,Medicine,Rayan Hospital,RYN_IP,,,,1162050660,11-04-2024,2.1,-4.2,8546106.0,PCS,Issue to Patient,2.0,1.5801,-3.16019,491.0,775.82672
6590020029,MAGNESIUM SULPHATE 50% INJ -5ML,Medicine,Rayan Hospital,RYN_IP,,,,1162057088,11-04-2024,2.1,-2.1,8546104.0,PCS,Issue to Patient,1.0,1.5801,-1.5801,490.0,774.24662
6590020029,MAGNESIUM SULPHATE 50% INJ -5ML,Medicine,Rayan Hospital,RYN_IP,,,,1162057983,11-04-2024,2.1,-4.2,8546103.0,PCS,Issue to Patient,2.0,1.5801,-3.16019,488.0,771.08643
6590020029,MAGNESIUM SULPHATE 50% INJ -5ML,Medicine,Rayan Hospital,RYN_IP,,,,1162076514,11-04-2024,2.1,-2.1,8546111.0,PCS,Issue to Patient,1.0,1.5801,-1.5801,488.0,771.08643
6590020029,MAGNESIUM SULPHATE 50% INJ -5ML,Medicine,Rayan Hospital,RYN_IP,,,,1162076524,11-04-2024,2.1,-2.1,8546111.0,PCS,Issue to Patient,1.0,1.5801,-1.5801,487.0,769.50634
6590020029,MAGNESIUM SULPHATE 50% INJ -5ML,Medicine,Rayan Hospital,RYN_IP,,,,1162076814,11-04-2024,2.1,-2.1,8546111.0,PCS,Issue to Patient,1.0,1.5801,-1.5801,486.0,767.92624
6590020029,MAGNESIUM SULPHATE 50% INJ -5ML,Medicine,Rayan Hospital,RYN_IP,,,,1162077276,11-04-2024,2.1,-2.1,8546111.0,PCS,Issue to Patient,1.0,1.5801,-1.5801,485.0,766.34615
6590020029,MAGNESIUM SULPHATE 50% INJ -5ML,Medicine,Rayan Hospital,RYN_IP,,,,1162077286,11-04-2024,2.1,-2.1,8546104.0,PCS,Issue to Patient,1.0,1.5801,-1.5801,484.0,764.76605
6590020029,MAGNESIUM SULPHATE 50% INJ -5ML,Medicine,Rayan Hospital,RYN_IP,,,,1162077301,11-04-2024,2.1,-2.1,8546111.0,PCS,Issue to Patient,1.0,1.5801,-1.5801,483.0,763.18596
6590020029,MAGNESIUM SULPHATE 50% INJ -5ML,Medicine,Rayan Hospital,RYN_IP,,,,1162120999,11-04-2024,2.1,-2.1,8546104.0,PCS,Issue to Patient,1.0,1.5801,-1.5801,482.0,761.60586
6590020029,MAGNESIUM SULPHATE 50% INJ -5ML,Medicine,Rayan Hospital,RYN_IP,,,,1162215671,12-04-2024,2.1,-2.1,8546106.0,PCS,Issue to Patient,1.0,1.5801,-1.5801,481.0,760.02577
6590020029,MAGNESIUM SULPHATE 50% INJ -5ML,Medicine,Rayan Hospital,RYN_IP,,,,1162236990,12-04-2024,2.1,-2.1,8546104.0,PCS,Issue to Patient,1.0,1.5801,-1.5801,480.0,758.44567
6590020029,MAGNESIUM SULPHATE 50% INJ -5ML,Medicine,Rayan Hospital,RYN_IP,,,,1162256195,12-04-2024,2.1,-4.2,8546103.0,PCS,Issue to Patient,2.0,1.5801,-3.16019,478.0,755.28548
6590020029,MAGNESIUM SULPHATE 50% INJ -5ML,Medicine,Rayan Hospital,RYN_IP,,,,1162280069,12-04-2024,2.1,-2.1,8546103.0,PCS,Issue to Patient,1.0,1.5801,-1.5801,477.0,753.70539
6590020029,MAGNESIUM SULPHATE 50% INJ -5ML,Medicine,Rayan Hospital,RYN_IP,,,,1162280596,12-04-2024,2.1,-2.1,8546103.0,PCS,Issue to Patient,1.0,1.5801,-1.5801,476.0,752.12529
6590020029,MAGNESIUM SULPHATE 50% INJ -5ML,Medicine,Rayan Hospital,RYN_IP,,,,1162281140,12-04-2024,2.1,-2.1,8546103.0,PCS,Issue to Patient,1.0,1.5801,-1.5801,475.0,750.54519
6590020029,MAGNESIUM SULPHATE 50% INJ -5ML,Medicine,Rayan Hospital,RYN_IP,,,,1162375718,13-04-2024,2.1,-2.1,8546106.0,PCS,Issue to Patient,1.0,1.5801,-1.5801,474.0,748.9651
6590020029,MAGNESIUM SULPHATE 50% INJ -5ML,Medicine,Rayan Hospital,RYN_IP,,,,1162407659,13-04-2024,2.1,-4.2,8546104.0,PCS,Issue to Patient,2.0,1.5801,-3.16019,472.0,745.80491
6590020029,MAGNESIUM SULPHATE 50% INJ -5ML,Medicine,Rayan Hospital,RYN_IP,,,,1162411294,13-04-2024,2.1,-2.1,8546106.0,PCS,Issue to Patient,1.0,1.5801,-1.5801,471.0,744.22481
6590020029,MAGNESIUM SULPHATE 50% INJ -5ML,Medicine,Rayan Hospital,RYN_IP,,,,1162418599,13-04-2024,2.1,-4.2,8546106.0,PCS,Issue to Patient,2.0,1.5801,-3.16019,469.0,741.06462
6590020029,MAGNESIUM SULPHATE 50% INJ -5ML,Medicine,Rayan Hospital,RYN_IP,,,,1162419890,13-04-2024,2.1,-4.2,8546104.0,PCS,Issue to Patient,2.0,1.5801,-3.16019,467.0,737.90443
6590020029,MAGNESIUM SULPHATE 50% INJ -5ML,Medicine,Rayan Hospital,RYN_IP,,,,1162484561,13-04-2024,2.1,-4.2,8546106.0,PCS,Issue to Patient,2.0,1.5801,-3.16019,465.0,734.74424
6590020029,MAGNESIUM SULPHATE 50% INJ -5ML,Medicine,Rayan Hospital,RYN_IP,,,,1162624664,14-04-2024,2.1,-2.1,8546111.0,PCS,Issue to Patient,1.0,1.5801,-1.5801,464.0,733.16415
6590020029,MAGNESIUM SULPHATE 50% INJ -5ML,Medicine,Rayan Hospital,RYN_IP,,,,1162625295,14-04-2024,2.1,-8.4,8546104.0,PCS,Issue to Patient,4.0,1.5801,-6.32038,460.0,726.84377
6590020029,MAGNESIUM SULPHATE 50% INJ -5ML,Medicine,Rayan Hospital,RYN_IP,,,,1162625305,14-04-2024,2.1,-2.1,8546103.0,PCS,Issue to Patient,1.0,1.5801,-1.5801,459.0,725.26367
6590020029,MAGNESIUM SULPHATE 50% INJ -5ML,Medicine,Rayan Hospital,RYN_IP,,,,1162638271,14-04-2024,2.1,-2.1,8546103.0,PCS,Issue to Patient,1.0,1.5801,-1.5801,459.0,725.26367
6590020029,MAGNESIUM SULPHATE 50% INJ -5ML,Medicine,Rayan Hospital,RYN_IP,,,,1162685673,14-04-2024,2.1,-4.2,8546106.0,PCS,Issue to Patient,2.0,1.5801,-3.16019,457.0,722.10348
6590020029,MAGNESIUM SULPHATE 50% INJ -5ML,Medicine,Rayan Hospital,RYN_IP,,,,1162687535,14-04-2024,2.1,-4.2,8546103.0,PCS,Issue to Patient,2.0,1.5801,-3.16019,455.0,718.94329
6590020029,MAGNESIUM SULPHATE 50% INJ -5ML,Medicine,Rayan Hospital,RYN_IP,,,,1162692539,14-04-2024,2.1,-2.1,8546106.0,PCS,Issue to Patient,1.0,1.5801,-1.5801,454.0,717.3632
6590020029,MAGNESIUM SULPHATE 50% INJ -5ML,Medicine,Rayan Hospital,RYN_IP,,,,1162797123,14-04-2024,2.1,-2.1,8546111.0,PCS,Issue to Patient,1.0,1.5801,-1.5801,453.0,715.7831
6590020029,MAGNESIUM SULPHATE 50% INJ -5ML,Medicine,Rayan Hospital,RYN_IP,,,,1162797588,14-04-2024,2.1,-2.1,8546111.0,PCS,Issue to Patient,1.0,1.5801,-1.5801,452.0,714.20301
6590020029,MAGNESIUM SULPHATE 50% INJ -5ML,Medicine,Rayan Hospital,RYN_IP,,,,1162802365,14-04-2024,2.1,-2.1,8546111.0,PCS,Issue to Patient,1.0,1.5801,-1.5801,451.0,712.62291
6590020029,MAGNESIUM SULPHATE 50% INJ -5ML,Medicine,Rayan Hospital,RYN_IP,,,,1162803790,14-04-2024,2.1,-2.1,8546111.0,PCS,Issue to Patient,1.0,1.5801,-1.5801,450.0,711.04282
6590020029,MAGNESIUM SULPHATE 50% INJ -5ML,Medicine,Rayan Hospital,RYN_IP,,,,1162829777,14-04-2024,2.1,-2.1,8546104.0,PCS,Issue to Patient,1.0,1.5801,-1.5801,449.0,709.46272
6590020029,MAGNESIUM SULPHATE 50% INJ -5ML,Medicine,Rayan Hospital,RYN_IP,,,,1163028794,14-04-2024,2.1,-4.2,8546103.0,PCS,Issue to Patient,2.0,1.5801,-3.16019,447.0,706.30253
6590020029,MAGNESIUM SULPHATE 50% INJ -5ML,Medicine,Rayan Hospital,RYN_IP,,,,1163065523,14-04-2024,2.1,-4.2,8546106.0,PCS,Issue to Patient,2.0,1.5801,-3.16019,445.0,703.14234
6590020029,MAGNESIUM SULPHATE 50% INJ -5ML,Medicine,Rayan Hospital,RYN_IP,,,,1163124973,15-04-2024,2.1,-2.1,8546104.0,PCS,Issue to Patient,1.0,1.5801,-1.5801,444.0,701.56225
6590020029,MAGNESIUM SULPHATE 50% INJ -5ML,Medicine,Rayan Hospital,RYN_IP,,,,1163125173,15-04-2024,2.1,-2.1,8546104.0,PCS,Issue to Patient,1.0,1.5801,-1.5801,443.0,699.98215
6590020029,MAGNESIUM SULPHATE 50% INJ -5ML,Medicine,Rayan Hospital,RYN_IP,,,,1163141404,15-04-2024,2.1,-2.1,8546103.0,PCS,Issue to Patient,1.0,1.5801,-1.5801,442.0,698.40205
6590020029,MAGNESIUM SULPHATE 50% INJ -5ML,Medicine,Rayan Hospital,RYN_IP,,,,1163154858,15-04-2024,2.1,-2.1,8546106.0,PCS,Issue to Patient,1.0,1.5801,-1.5801,441.0,696.82196
6590020029,MAGNESIUM SULPHATE 50% INJ -5ML,Medicine,Rayan Hospital,RYN_IP,,,,1163167336,15-04-2024,2.1,-8.4,8546104.0,PCS,Issue to Patient,4.0,1.5801,-6.32038,437.0,690.50158
6590020029,MAGNESIUM SULPHATE 50% INJ -5ML,Medicine,Rayan Hospital,RYN_IP,,,,1163226573,15-04-2024,2.1,-4.2,8546103.0,PCS,Issue to Patient,2.0,1.5801,-3.16019,437.0,690.50158
6590020029,MAGNESIUM SULPHATE 50% INJ -5ML,Medicine,Rayan Hospital,RYN_IP,,,,1163266377,15-04-2024,2.1,-4.2,8546106.0,PCS,Issue to Patient,2.0,1.5801,-3.16019,435.0,687.34139
6590020029,MAGNESIUM SULPHATE 50% INJ -5ML,Medicine,Rayan Hospital,RYN_IP,,,,1163452359,15-04-2024,2.1,-2.1,8546103.0,PCS,Issue to Patient,1.0,1.5801,-1.5801,434.0,685.76129
6590020029,MAGNESIUM SULPHATE 50% INJ -5ML,Medicine,Rayan Hospital,RYN_IP,,,,1163462821,15-04-2024,2.1,-2.1,8546104.0,PCS,Issue to Patient,1.0,1.5801,-1.5801,433.0,684.1812
6590020029,MAGNESIUM SULPHATE 50% INJ -5ML,Medicine,Rayan Hospital,RYN_IP,,,,1163755303,16-04-2024,2.1,-2.1,8546106.0,PCS,Issue to Patient,1.0,1.5801,-1.5801,432.0,682.6011
6590020029,MAGNESIUM SULPHATE 50% INJ -5ML,Medicine,Rayan Hospital,RYN_IP,,,,1163761316,16-04-2024,2.1,-2.1,8546103.0,PCS,Issue to Patient,1.0,1.5801,-1.5801,431.0,681.02101
6590020029,MAGNESIUM SULPHATE 50% INJ -5ML,Medicine,Rayan Hospital,RYN_IP,,,,1163770864,16-04-2024,2.1,-4.2,8546106.0,PCS,Issue to Patient,2.0,1.5801,-3.16019,429.0,677.86082
6590020029,MAGNESIUM SULPHATE 50% INJ -5ML,Medicine,Rayan Hospital,RYN_IP,,,,1163778096,16-04-2024,2.1,-4.2,8546103.0,PCS,Issue to Patient,2.0,1.5801,-3.16019,427.0,674.70063
6590020029,MAGNESIUM SULPHATE 50% INJ -5ML,Medicine,Rayan Hospital,RYN_IP,,,,1163871714,16-04-2024,2.1,-4.2,8546106.0,PCS,Issue to Patient,2.0,1.5801,-3.16019,425.0,671.54044
6590020029,MAGNESIUM SULPHATE 50% INJ -5ML,Medicine,Rayan Hospital,RYN_IP,,,,1163879445,16-04-2024,2.1,-4.2,8546104.0,PCS,Issue to Patient,2.0,1.5801,-3.16019,423.0,668.38025
6590020029,MAGNESIUM SULPHATE 50% INJ -5ML,Medicine,Rayan Hospital,RYN_IP,,,,1164029661,16-04-2024,2.1,-2.1,8546111.0,PCS,Issue to Patient,1.0,1.5801,-1.5801,422.0,666.80015
6590020029,MAGNESIUM SULPHATE 50% INJ -5ML,Medicine,Rayan Hospital,RYN_IP,,,,1164031475,16-04-2024,2.1,-2.1,8546111.0,PCS,Issue to Patient,1.0,1.5801,-1.5801,421.0,665.22006
6590020029,MAGNESIUM SULPHATE 50% INJ -5ML,Medicine,Rayan Hospital,RYN_IP,,,,1164037129,16-04-2024,2.1,-2.1,8546111.0,PCS,Issue to Patient,1.0,1.5801,-1.5801,420.0,663.63996
6590020029,MAGNESIUM SULPHATE 50% INJ -5ML,Medicine,Rayan Hospital,RYN_IP,,,,1164037134,16-04-2024,2.1,-2.1,8546111.0,PCS,Issue to Patient,1.0,1.5801,-1.5801,419.0,662.05987
6590020029,MAGNESIUM SULPHATE 50% INJ -5ML,Medicine,Rayan Hospital,RYN_IP,,,,1164037653,16-04-2024,2.1,-2.1,8546111.0,PCS,Issue to Patient,1.0,1.5801,-1.5801,418.0,660.47977
6590020029,MAGNESIUM SULPHATE 50% INJ -5ML,Medicine,Rayan Hospital,RYN_IP,,,,1164241571,17-04-2024,2.1,-4.2,8546103.0,PCS,Issue to Patient,2.0,1.5801,-3.16019,416.0,657.31958
6590020029,MAGNESIUM SULPHATE 50% INJ -5ML,Medicine,Rayan Hospital,RYN_IP,,,,1164250225,17-04-2024,2.1,-4.2,8546106.0,PCS,Issue to Patient,2.0,1.5801,-3.16019,414.0,654.15939
6590020029,MAGNESIUM SULPHATE 50% INJ -5ML,Medicine,Rayan Hospital,RYN_IP,,,,1164257800,17-04-2024,2.1,-4.2,8546104.0,PCS,Issue to Patient,2.0,1.5801,-3.16019,412.0,650.9992
6590020029,MAGNESIUM SULPHATE 50% INJ -5ML,Medicine,Rayan Hospital,RYN_IP,,,,1164291905,17-04-2024,2.1,-4.2,8546103.0,PCS,Issue to Patient,2.0,1.5801,-3.16019,410.0,647.83901
6590020029,MAGNESIUM SULPHATE 50% INJ -5ML,Medicine,Rayan Hospital,RYN_IP,,,,1164314647,17-04-2024,2.1,-2.1,8546106.0,PCS,Issue to Patient,1.0,1.5801,-1.5801,409.0,646.25892
6590020029,MAGNESIUM SULPHATE 50% INJ -5ML,Medicine,Rayan Hospital,RYN_IP,,,,1164322045,17-04-2024,2.1,-4.2,8546104.0,PCS,Issue to Patient,2.0,1.5801,-3.16019,407.0,643.09872
6590020029,MAGNESIUM SULPHATE 50% INJ -5ML,Medicine,Rayan Hospital,RYN_IP,,,,1164323500,17-04-2024,2.1,-4.2,8546103.0,PCS,Issue to Patient,2.0,1.5801,-3.16019,405.0,639.93853
6590020029,MAGNESIUM SULPHATE 50% INJ -5ML,Medicine,Rayan Hospital,RYN_IP,,,,1164338303,17-04-2024,2.1,-4.2,8546106.0,PCS,Issue to Patient,2.0,1.5801,-3.16019,403.0,636.77834
6590020029,MAGNESIUM SULPHATE 50% INJ -5ML,Medicine,Rayan Hospital,RYN_IP,,,,1164358689,17-04-2024,2.1,-4.2,8546104.0,PCS,Issue to Patient,2.0,1.5801,-3.16019,401.0,633.61815
6590020029,MAGNESIUM SULPHATE 50% INJ -5ML,Medicine,Rayan Hospital,RYN_IP,,,,1164396829,17-04-2024,2.1,-2.1,8546103.0,PCS,Issue to Patient,1.0,1.5801,-1.5801,400.0,632.03806
6590020029,MAGNESIUM SULPHATE 50% INJ -5ML,Medicine,Rayan Hospital,RYN_IP,,,,1164550111,17-04-2024,2.1,-2.1,8546103.0,PCS,Issue to Patient,1.0,2.09887,-2.09887,799.0,1676.99503
6590020029,MAGNESIUM SULPHATE 50% INJ -5ML,Medicine,Rayan Hospital,RYN_IP,,,,1164554850,17-04-2024,2.1,-2.1,8546104.0,PCS,Issue to Patient,1.0,2.09887,-2.09887,798.0,1674.89617
6590020029,MAGNESIUM SULPHATE 50% INJ -5ML,Medicine,Rayan Hospital,RYN_IP,,,,1164562626,17-04-2024,2.1,-2.1,8546104.0,PCS,Issue to Patient,1.0,2.09887,-2.09887,797.0,1672.7973
6590020029,MAGNESIUM SULPHATE 50% INJ -5ML,Medicine,Rayan Hospital,RYN_IP,,,,1164564021,17-04-2024,2.1,-2.1,8546104.0,PCS,Issue to Patient,1.0,2.09887,-2.09887,796.0,1670.69843
6590020029,MAGNESIUM SULPHATE 50% INJ -5ML,Medicine,Rayan Hospital,RYN_IP,,,,1165013769,18-04-2024,2.1,-2.1,8546103.0,PCS,Issue to Patient,1.0,2.09887,-2.09887,795.0,1668.59956
6590020029,MAGNESIUM SULPHATE 50% INJ -5ML,Medicine,Rayan Hospital,RYN_IP,,,,1165013795,18-04-2024,4.2,-8.4,8546112.0,PCS,Issue to Patient,2.0,2.09887,-4.19773,793.0,1664.40183
6590020029,MAGNESIUM SULPHATE 50% INJ -5ML,Medicine,Rayan Hospital,RYN_IP,,,,1165023954,18-04-2024,2.1,-2.1,8546104.0,PCS,Issue to Patient,1.0,2.09887,-2.09887,792.0,1662.30296
6590020029,MAGNESIUM SULPHATE 50% INJ -5ML,Medicine,Rayan Hospital,RYN_IP,,,,1165028928,18-04-2024,2.1,-2.1,8546103.0,PCS,Issue to Patient,1.0,2.09887,-2.09887,791.0,1660.20409
6590020029,MAGNESIUM SULPHATE 50% INJ -5ML,Medicine,Rayan Hospital,RYN_IP,,,,1165036697,18-04-2024,2.1,-2.1,8546103.0,PCS,Issue to Patient,1.0,2.09887,-2.09887,790.0,1658.10523
6590020029,MAGNESIUM SULPHATE 50% INJ -5ML,Medicine,Rayan Hospital,RYN_IP,,,,1165416367,19-04-2024,4.2,-4.2,8546112.0,PCS,Issue to Patient,1.0,2.09887,-2.09887,789.0,1656.00636
6590020029,MAGNESIUM SULPHATE 50% INJ -5ML,Medicine,Rayan Hospital,RYN_IP,,,,1165447088,19-04-2024,4.2,-4.2,8546112.0,PCS,Issue to Patient,1.0,2.09887,-2.09887,788.0,1653.90749
6590020029,MAGNESIUM SULPHATE 50% INJ -5ML,Medicine,Rayan Hospital,RYN_IP,,,,1165486290,19-04-2024,2.1,-2.1,8546103.0,PCS,Issue to Patient,1.0,2.09887,-2.09887,787.0,1651.80863
6590020029,MAGNESIUM SULPHATE 50% INJ -5ML,Medicine,Rayan Hospital,RYN_IP,,,,1165489388,19-04-2024,2.1,-2.1,8546103.0,PCS,Issue to Patient,1.0,2.09887,-2.09887,786.0,1649.70976
6590020029,MAGNESIUM SULPHATE 50% INJ -5ML,Medicine,Rayan Hospital,RYN_IP,,,,1165490649,19-04-2024,2.1,-2.1,8546103.0,PCS,Issue to Patient,1.0,2.09887,-2.09887,785.0,1647.61089
6590020029,MAGNESIUM SULPHATE 50% INJ -5ML,Medicine,Rayan Hospital,RYN_IP,,,,1165491934,19-04-2024,2.1,-2.1,8546103.0,PCS,Issue to Patient,1.0,2.09887,-2.09887,784.0,1645.51202
6590020029,MAGNESIUM SULPHATE 50% INJ -5ML,Medicine,Rayan Hospital,RYN_IP,,,,1165596724,20-04-2024,4.2,-8.4,8546112.0,PCS,Issue to Patient,2.0,2.09887,-4.19773,782.0,1641.31429
6590020029,MAGNESIUM SULPHATE 50% INJ -5ML,Medicine,Rayan Hospital,RYN_IP,,,,1165672286,20-04-2024,4.2,-8.4,8546112.0,PCS,Issue to Patient,2.0,2.09887,-4.19773,780.0,1637.11655
6590020029,MAGNESIUM SULPHATE 50% INJ -5ML,Medicine,Rayan Hospital,RYN_IP,,,,1165723824,20-04-2024,4.2,-4.2,8546112.0,PCS,Issue to Patient,1.0,2.09887,-2.09887,779.0,1635.01769
6590020029,MAGNESIUM SULPHATE 50% INJ -5ML,Medicine,Rayan Hospital,RYN_IP,,,,1165768028,20-04-2024,2.1,-2.1,8546103.0,PCS,Issue to Patient,1.0,2.09887,-2.09887,778.0,1632.91882
6590020029,MAGNESIUM SULPHATE 50% INJ -5ML,Medicine,Rayan Hospital,RYN_IP,,,,1165945997,20-04-2024,4.2,-8.4,8546112.0,PCS,Issue to Patient,2.0,2.09887,-4.19773,776.0,1628.72108
6590020029,MAGNESIUM SULPHATE 50% INJ -5ML,Medicine,Rayan Hospital,RYN_IP,,,,1166405926,21-04-2024,2.1,-2.1,8546103.0,PCS,Issue to Patient,1.0,2.09887,-2.09887,775.0,1626.62222
6590020029,MAGNESIUM SULPHATE 50% INJ -5ML,Medicine,Rayan Hospital,RYN_IP,,,,1166408095,21-04-2024,2.1,-2.1,8546103.0,PCS,Issue to Patient,1.0,2.09887,-2.09887,774.0,1624.52335
6590020029,MAGNESIUM SULPHATE 50% INJ -5ML,Medicine,Rayan Hospital,RYN_IP,,,,1166408385,21-04-2024,2.1,-2.1,8546103.0,PCS,Issue to Patient,1.0,2.09887,-2.09887,773.0,1622.42448
6590020029,MAGNESIUM SULPHATE 50% INJ -5ML,Medicine,Rayan Hospital,RYN_IP,,,,1166466840,21-04-2024,4.2,-4.2,8546112.0,PCS,Issue to Patient,1.0,2.09887,-2.09887,772.0,1620.32561
6590020029,MAGNESIUM SULPHATE 50% INJ -5ML,Medicine,Rayan Hospital,RYN_IP,,,,1166892534,22-04-2024,4.2,-8.4,8546112.0,PCS,Issue to Patient,2.0,2.09887,-4.19773,770.0,1616.12788
6590020029,MAGNESIUM SULPHATE 50% INJ -5ML,Medicine,Rayan Hospital,RYN_IP,,,,1166892671,22-04-2024,4.2,-8.4,8546112.0,PCS,Issue to Patient,2.0,2.09887,-4.19773,768.0,1611.93014
6590020029,MAGNESIUM SULPHATE 50% INJ -5ML,Medicine,Rayan Hospital,RYN_IP,,,,1166898180,22-04-2024,4.2,-8.4,8546112.0,PCS,Issue to Patient,2.0,2.09887,-4.19773,766.0,1607.73241
6590020029,MAGNESIUM SULPHATE 50% INJ -5ML,Medicine,Rayan Hospital,STAGE,Rayan Hospital Clinics,RAY_ANSTHA,17545921,1166970524,22-04-2024,2.1,-10.5,8546104.0,PCS,Int Order Direct Ship,5.0,2.09887,-10.49434,761.0,1597.23807
6590020029,MAGNESIUM SULPHATE 50% INJ -5ML,Medicine,Rayan Hospital,RYN_IP,,,,1166992564,22-04-2024,2.1,-2.1,8546103.0,PCS,Issue to Patient,1.0,2.09887,-2.09887,760.0,1595.13921
6590020029,MAGNESIUM SULPHATE 50% INJ -5ML,Medicine,Rayan Hospital,RYN_IP,,,,1166992614,22-04-2024,2.1,-2.1,8546103.0,PCS,Issue to Patient,1.0,2.09887,-2.09887,759.0,1593.04034
6590020029,MAGNESIUM SULPHATE 50% INJ -5ML,Medicine,Rayan Hospital,RYN_IP,,,,1167403467,23-04-2024,4.2,-4.2,8546112.0,PCS,Issue to Patient,1.0,2.09887,-2.09887,758.0,1590.94147
6590020029,MAGNESIUM SULPHATE 50% INJ -5ML,Medicine,Rayan Hospital,RYN_IP,,,,1167449534,23-04-2024,4.2,-4.2,8546112.0,PCS,Issue to Patient,1.0,2.09887,-2.09887,757.0,1588.8426
6590020029,MAGNESIUM SULPHATE 50% INJ -5ML,Medicine,Rayan Hospital,RYN_IP,,,,1167451361,23-04-2024,4.2,-8.4,8546112.0,PCS,Issue to Patient,2.0,2.09887,-4.19773,755.0,1584.64487
6590020029,MAGNESIUM SULPHATE 50% INJ -5ML,Medicine,Rayan Hospital,RYN_IP,,,,1167473118,23-04-2024,4.2,-8.4,8546112.0,PCS,Issue to Patient,2.0,2.09887,-4.19773,753.0,1580.44713
6590020029,MAGNESIUM SULPHATE 50% INJ -5ML,Medicine,Rayan Hospital,RYN_IP,,,,1167519813,23-04-2024,2.1,-4.2,8546106.0,PCS,Issue to Patient,2.0,2.09887,-4.19773,751.0,1576.2494
6590020029,MAGNESIUM SULPHATE 50% INJ -5ML,Medicine,Rayan Hospital,RYN_IP,,,,1167550988,23-04-2024,2.1,-6.3,8546103.0,PCS,Issue to Patient,3.0,2.09887,-6.2966,748.0,1569.9528
6590020029,MAGNESIUM SULPHATE 50% INJ -5ML,Medicine,Rayan Hospital,RYN_IP,,,,1167552726,23-04-2024,4.2,-4.2,8546112.0,PCS,Issue to Patient,1.0,2.09887,-2.09887,747.0,1567.85393
6590020029,MAGNESIUM SULPHATE 50% INJ -5ML,Medicine,Rayan Hospital,RYN_IP,,,,1167565074,23-04-2024,4.2,-4.2,8546112.0,PCS,Issue to Patient,1.0,2.09887,-2.09887,748.0,1569.9528
6590020029,MAGNESIUM SULPHATE 50% INJ -5ML,Medicine,Rayan Hospital,RYN_IP,,,,1167587245,23-04-2024,2.1,-2.1,8546103.0,PCS,Issue to Patient,1.0,2.09887,-2.09887,747.0,1567.85393
6590020029,MAGNESIUM SULPHATE 50% INJ -5ML,Medicine,Rayan Hospital,RYN_IP,,,,1167866688,23-04-2024,4.2,-4.2,8546112.0,PCS,Issue to Patient,1.0,2.09887,-2.09887,746.0,1565.75506
6590020029,MAGNESIUM SULPHATE 50% INJ -5ML,Medicine,Rayan Hospital,RYN_IP,,,,1168117755,24-04-2024,4.2,-4.2,8546112.0,PCS,Issue to Patient,1.0,2.09887,-2.09887,745.0,1563.6562
6590020029,MAGNESIUM SULPHATE 50% INJ -5ML,Medicine,Rayan Hospital,RYN_IP,,,,1168143893,24-04-2024,4.2,-8.4,8546112.0,PCS,Issue to Patient,2.0,2.09887,-4.19773,743.0,1559.45846
6590020029,MAGNESIUM SULPHATE 50% INJ -5ML,Medicine,Rayan Hospital,RYN_IP,,,,1168179812,24-04-2024,2.1,-2.1,8546103.0,PCS,Issue to Patient,1.0,2.09887,-2.09887,742.0,1557.35959
6590020029,MAGNESIUM SULPHATE 50% INJ -5ML,Medicine,Rayan Hospital,RYN_IP,,,,1168184844,24-04-2024,2.1,-2.1,8546103.0,PCS,Issue to Patient,1.0,2.09887,-2.09887,741.0,1555.26073
6590020029,MAGNESIUM SULPHATE 50% INJ -5ML,Medicine,Rayan Hospital,RYN_IP,,,,1168187027,24-04-2024,2.1,-2.1,8546103.0,PCS,Issue to Patient,1.0,2.09887,-2.09887,740.0,1553.16186
6590020029,MAGNESIUM SULPHATE 50% INJ -5ML,Medicine,Rayan Hospital,RYN_IP,,,,1168192000,24-04-2024,2.1,-2.1,8546103.0,PCS,Issue to Patient,1.0,2.09887,-2.09887,739.0,1551.06299
6590020029,MAGNESIUM SULPHATE 50% INJ -5ML,Medicine,Rayan Hospital,RYN_IP,,,,1168251077,24-04-2024,4.2,-8.4,8546112.0,PCS,Issue to Patient,2.0,2.09887,-4.19773,737.0,1546.86526
6590020029,MAGNESIUM SULPHATE 50% INJ -5ML,Medicine,Rayan Hospital,RYN_IP,,,,1168458613,24-04-2024,4.2,-4.2,8546112.0,PCS,Issue to Patient,1.0,2.09887,-2.09887,736.0,1544.76639
6590020029,MAGNESIUM SULPHATE 50% INJ -5ML,Medicine,Rayan Hospital,RYN_IP,,,,1168563920,25-04-2024,4.2,-8.4,8546112.0,PCS,Issue to Patient,2.0,2.09887,-4.19773,734.0,1540.56865
6590020029,MAGNESIUM SULPHATE 50% INJ -5ML,Medicine,Rayan Hospital,RYN_IP,,,,1168776359,25-04-2024,4.2,-4.2,8546112.0,PCS,Issue to Patient,1.0,2.09887,-2.09887,734.0,1540.56865
6590020029,MAGNESIUM SULPHATE 50% INJ -5ML,Medicine,Rayan Hospital,RYN_IP,,,,1168912672,25-04-2024,2.1,-2.1,8546103.0,PCS,Issue to Patient,1.0,2.09887,-2.09887,733.0,1538.46979
6590020029,MAGNESIUM SULPHATE 50% INJ -5ML,Medicine,Rayan Hospital,RYN_IP,,,,1168914712,25-04-2024,2.1,-2.1,8546104.0,PCS,Issue to Patient,1.0,2.09887,-2.09887,732.0,1536.37092
6590020029,MAGNESIUM SULPHATE 50% INJ -5ML,Medicine,Rayan Hospital,RYN_IP,,,,1168915202,25-04-2024,2.1,-2.1,8546103.0,PCS,Issue to Patient,1.0,2.09887,-2.09887,731.0,1534.27205
6590020029,MAGNESIUM SULPHATE 50% INJ -5ML,Medicine,Rayan Hospital,RYN_IP,,,,1168917302,25-04-2024,2.1,-2.1,8546103.0,PCS,Issue to Patient,1.0,2.09887,-2.09887,730.0,1532.17318
6590020029,MAGNESIUM SULPHATE 50% INJ -5ML,Medicine,Rayan Hospital,RYN_IP,,,,1169038099,25-04-2024,4.2,-8.4,8546112.0,PCS,Issue to Patient,2.0,2.09887,-4.19773,728.0,1527.97545
6590020029,MAGNESIUM SULPHATE 50% INJ -5ML,Medicine,Rayan Hospital,RYN_IP,,,,1169075425,25-04-2024,4.2,-8.4,8546112.0,PCS,Issue to Patient,2.0,2.09887,-4.19773,726.0,1523.77772
6590020029,MAGNESIUM SULPHATE 50% INJ -5ML,Medicine,Rayan Hospital,RYN_IP,,,,1169161984,26-04-2024,4.2,-8.4,8546112.0,PCS,Issue to Patient,2.0,2.09887,-4.19773,724.0,1519.57998
6590020029,MAGNESIUM SULPHATE 50% INJ -5ML,Medicine,Rayan Hospital,RYN_IP,,,,1169163025,26-04-2024,4.2,-8.4,8546112.0,PCS,Issue to Patient,2.0,2.09887,-4.19773,722.0,1515.38225
6590020029,MAGNESIUM SULPHATE 50% INJ -5ML,Medicine,Rayan Hospital,RYN_IP,,,,1169167327,26-04-2024,4.2,-4.2,8546112.0,PCS,Issue to Patient,1.0,2.09887,-2.09887,721.0,1513.28338
6590020029,MAGNESIUM SULPHATE 50% INJ -5ML,Medicine,Rayan Hospital,RYN_IP,,,,1169177442,26-04-2024,4.2,-8.4,8546112.0,PCS,Issue to Patient,2.0,2.09887,-4.19773,719.0,1509.08564
6590020029,MAGNESIUM SULPHATE 50% INJ -5ML,Medicine,Rayan Hospital,RYN_IP,,,,1169231336,26-04-2024,4.2,-8.4,8546112.0,PCS,Issue to Patient,2.0,2.09887,-4.19773,717.0,1504.88791
6590020029,MAGNESIUM SULPHATE 50% INJ -5ML,Medicine,Rayan Hospital,RYN_IP,,,,1169252026,26-04-2024,2.1,-2.1,8546103.0,PCS,Issue to Patient,1.0,2.09887,-2.09887,716.0,1502.78904
6590020029,MAGNESIUM SULPHATE 50% INJ -5ML,Medicine,Rayan Hospital,RYN_IP,,,,1169252266,26-04-2024,2.1,-2.1,8546103.0,PCS,Issue to Patient,1.0,2.09887,-2.09887,715.0,1500.69017
6590020029,MAGNESIUM SULPHATE 50% INJ -5ML,Medicine,Rayan Hospital,RYN_IP,,,,1169253404,26-04-2024,2.1,-2.1,8546103.0,PCS,Issue to Patient,1.0,2.09887,-2.09887,714.0,1498.59131
6590020029,MAGNESIUM SULPHATE 50% INJ -5ML,Medicine,Rayan Hospital,RYN_IP,,,,1169253409,26-04-2024,2.1,-2.1,8546103.0,PCS,Issue to Patient,1.0,2.09887,-2.09887,713.0,1496.49244
6590020029,MAGNESIUM SULPHATE 50% INJ -5ML,Medicine,Rayan Hospital,RYN_IP,,,,1169357629,27-04-2024,4.2,-4.2,8546112.0,PCS,Issue to Patient,1.0,2.09887,-2.09887,712.0,1494.39357
6590020029,MAGNESIUM SULPHATE 50% INJ -5ML,Medicine,Rayan Hospital,RYN_IP,,,,1169362711,27-04-2024,4.2,-4.2,8546112.0,PCS,Issue to Patient,1.0,2.09887,-2.09887,711.0,1492.2947
6590020029,MAGNESIUM SULPHATE 50% INJ -5ML,Medicine,Rayan Hospital,RYN_IP,,,,1169420881,27-04-2024,4.2,-4.2,8546112.0,PCS,Issue to Patient,1.0,2.09887,-2.09887,710.0,1490.19584
6590020029,MAGNESIUM SULPHATE 50% INJ -5ML,Medicine,Rayan Hospital,RYN_IP,,,,1169421609,27-04-2024,4.2,-4.2,8546112.0,PCS,Issue to Patient,1.0,2.09887,-2.09887,709.0,1488.09697
6590020029,MAGNESIUM SULPHATE 50% INJ -5ML,Medicine,Rayan Hospital,RYN_IP,,,,1169452146,27-04-2024,4.2,-4.2,8546112.0,PCS,Issue to Patient,1.0,2.09887,-2.09887,708.0,1485.9981
6590020029,MAGNESIUM SULPHATE 50% INJ -5ML,Medicine,Rayan Hospital,RYN_IP,,,,1169459924,27-04-2024,4.2,-4.2,8546112.0,PCS,Issue to Patient,1.0,2.09887,-2.09887,707.0,1483.89923
6590020029,MAGNESIUM SULPHATE 50% INJ -5ML,Medicine,Rayan Hospital,RYN_IP,,,,1169473382,27-04-2024,4.2,-8.4,8546112.0,PCS,Issue to Patient,2.0,2.09887,-4.19773,705.0,1479.7015
6590020029,MAGNESIUM SULPHATE 50% INJ -5ML,Medicine,Rayan Hospital,RYN_IP,,,,1169585298,27-04-2024,4.2,-12.6,8546112.0,PCS,Issue to Patient,3.0,2.09887,-6.2966,702.0,1473.4049
6590020029,MAGNESIUM SULPHATE 50% INJ -5ML,Medicine,Rayan Hospital,RYN_IP,,,,1169612452,27-04-2024,4.2,-4.2,8546112.0,PCS,Issue to Patient,1.0,2.09887,-2.09887,701.0,1471.30603
6590020029,MAGNESIUM SULPHATE 50% INJ -5ML,Medicine,Rayan Hospital,RYN_IP,,,,1169618875,27-04-2024,4.2,-4.2,8546112.0,PCS,Issue to Patient,1.0,2.09887,-2.09887,700.0,1469.20716
6590020029,MAGNESIUM SULPHATE 50% INJ -5ML,Medicine,Rayan Hospital,RYN_IP,,,,1169620015,27-04-2024,4.2,-8.4,8546112.0,PCS,Issue to Patient,2.0,2.09887,-4.19773,698.0,1465.00943
6590020029,MAGNESIUM SULPHATE 50% INJ -5ML,Medicine,Rayan Hospital,RYN_IP,,,,1169708508,27-04-2024,2.1,-2.1,8546104.0,PCS,Issue to Patient,1.0,2.09887,-2.09887,697.0,1462.91056
6590020029,MAGNESIUM SULPHATE 50% INJ -5ML,Medicine,Rayan Hospital,RYN_IP,,,,1169709198,27-04-2024,2.1,-2.1,8546104.0,PCS,Issue to Patient,1.0,2.09887,-2.09887,696.0,1460.81169
6590020029,MAGNESIUM SULPHATE 50% INJ -5ML,Medicine,Rayan Hospital,RYN_IP,,,,1169711438,27-04-2024,2.1,-2.1,8546104.0,PCS,Issue to Patient,1.0,2.09887,-2.09887,695.0,1458.71283
6590020029,MAGNESIUM SULPHATE 50% INJ -5ML,Medicine,Rayan Hospital,RYN_IP,,,,1169712231,27-04-2024,2.1,-2.1,8546104.0,PCS,Issue to Patient,1.0,2.09887,-2.09887,694.0,1456.61396
6590020029,MAGNESIUM SULPHATE 50% INJ -5ML,Medicine,Rayan Hospital,RYN_IP,,,,1169719318,27-04-2024,4.2,-16.8,8546112.0,PCS,Issue to Patient,4.0,2.09887,-8.39547,690.0,1448.21849
6590020029,MAGNESIUM SULPHATE 50% INJ -5ML,Medicine,Rayan Hospital,RYN_IP,,,,1169726535,27-04-2024,4.2,-8.4,8546112.0,PCS,Issue to Patient,2.0,2.09887,-4.19773,688.0,1444.02075
6590020029,MAGNESIUM SULPHATE 50% INJ -5ML,Medicine,Rayan Hospital,RYN_IP,,,,1169819608,27-04-2024,4.2,-8.4,8546112.0,PCS,Issue to Patient,2.0,2.09887,-4.19773,686.0,1439.82302
6590020029,MAGNESIUM SULPHATE 50% INJ -5ML,Medicine,Rayan Hospital,RYN_IP,,,,1169830072,27-04-2024,4.2,-16.8,8546112.0,PCS,Issue to Patient,4.0,2.09887,-8.39547,682.0,1431.42755
6590020029,MAGNESIUM SULPHATE 50% INJ -5ML,Medicine,Rayan Hospital,RYN_IP,,,,1169995796,28-04-2024,4.2,-16.8,8546112.0,PCS,Issue to Patient,4.0,2.09887,-8.39547,681.0,1429.32868
6590020029,MAGNESIUM SULPHATE 50% INJ -5ML,Medicine,Rayan Hospital,RYN_IP,,,,1169999217,28-04-2024,2.1,-4.2,8546111.0,PCS,Issue to Patient,2.0,2.09887,-4.19773,679.0,1425.13095
6590020029,MAGNESIUM SULPHATE 50% INJ -5ML,Medicine,Rayan Hospital,RYN_IP,,,,1170031489,28-04-2024,4.2,-4.2,8546112.0,PCS,Issue to Patient,1.0,2.09887,-2.09887,678.0,1423.03208
6590020029,MAGNESIUM SULPHATE 50% INJ -5ML,Medicine,Rayan Hospital,RYN_IP,,,,1170053924,28-04-2024,4.2,-4.2,8546112.0,PCS,Issue to Patient,1.0,2.09887,-2.09887,677.0,1420.93321
6590020029,MAGNESIUM SULPHATE 50% INJ -5ML,Medicine,Rayan Hospital,RYN_IP,,,,1170095339,28-04-2024,4.2,-8.4,8546112.0,PCS,Issue to Patient,2.0,2.09887,-4.19773,675.0,1416.73548
6590020029,MAGNESIUM SULPHATE 50% INJ -5ML,Medicine,Rayan Hospital,RYN_IP,,,,1170225425,28-04-2024,4.2,-8.4,8546112.0,PCS,Issue to Patient,2.0,2.09887,-4.19773,673.0,1412.53774
6590020029,MAGNESIUM SULPHATE 50% INJ -5ML,Medicine,Rayan Hospital,RYN_IP,,,,1170246363,28-04-2024,4.2,-16.8,8546112.0,PCS,Issue to Patient,4.0,2.09887,-8.39547,669.0,1404.14227
6590020029,MAGNESIUM SULPHATE 50% INJ -5ML,Medicine,Rayan Hospital,RYN_IP,,,,1170246383,28-04-2024,4.2,-8.4,8546112.0,PCS,Issue to Patient,2.0,2.09887,-4.19773,667.0,1399.94454
6590020029,MAGNESIUM SULPHATE 50% INJ -5ML,Medicine,Rayan Hospital,RYN_IP,,,,1170281897,28-04-2024,4.2,-4.2,8546112.0,PCS,Issue to Patient,1.0,2.09887,-2.09887,666.0,1397.84567
6590020029,MAGNESIUM SULPHATE 50% INJ -5ML,Medicine,Rayan Hospital,RYN_IP,,,,1170288463,28-04-2024,4.2,-4.2,8546112.0,PCS,Issue to Patient,1.0,2.09887,-2.09887,665.0,1395.74681
6590020029,MAGNESIUM SULPHATE 50% INJ -5ML,Medicine,Rayan Hospital,RYN_IP,,,,1170304918,28-04-2024,4.2,-4.2,8546112.0,PCS,Issue to Patient,1.0,2.09887,-2.09887,664.0,1393.64794
6590020029,MAGNESIUM SULPHATE 50% INJ -5ML,Medicine,Rayan Hospital,RYN_IP,,,,1170439429,28-04-2024,4.2,-8.4,8546112.0,PCS,Issue to Patient,2.0,2.09887,-4.19773,662.0,1389.4502
6590020029,MAGNESIUM SULPHATE 50% INJ -5ML,Medicine,Rayan Hospital,RYN_IP,,,,1170590557,29-04-2024,4.2,-4.2,8546112.0,PCS,Issue to Patient,1.0,2.09887,-2.09887,661.0,1387.35134
6590020029,MAGNESIUM SULPHATE 50% INJ -5ML,Medicine,Rayan Hospital,RYN_IP,,,,1170740207,29-04-2024,4.2,-8.4,8546112.0,PCS,Issue to Patient,2.0,2.09887,-4.19773,659.0,1383.1536
6590020029,MAGNESIUM SULPHATE 50% INJ -5ML,Medicine,Rayan Hospital,RYN_IP,,,,1170749722,29-04-2024,4.2,-4.2,8546112.0,PCS,Issue to Patient,1.0,2.09887,-2.09887,658.0,1381.05473
6590020029,MAGNESIUM SULPHATE 50% INJ -5ML,Medicine,Rayan Hospital,RYN_IP,,,,1170778727,29-04-2024,4.2,-8.4,8546112.0,PCS,Issue to Patient,2.0,2.09887,-4.19773,656.0,1376.857
6590020029,MAGNESIUM SULPHATE 50% INJ -5ML,Medicine,Rayan Hospital,RYN_IP,,,,1170835312,29-04-2024,2.1,-2.1,8546104.0,PCS,Issue to Patient,1.0,2.09887,-2.09887,655.0,1374.75813
6590020029,MAGNESIUM SULPHATE 50% INJ -5ML,Medicine,Rayan Hospital,RYN_IP,,,,1170841034,29-04-2024,2.1,-2.1,8546103.0,PCS,Issue to Patient,1.0,2.09887,-2.09887,654.0,1372.65926
6590020029,MAGNESIUM SULPHATE 50% INJ -5ML,Medicine,Rayan Hospital,RYN_IP,,,,1170850026,29-04-2024,4.2,-4.2,8546112.0,PCS,Issue to Patient,1.0,2.09887,-2.09887,653.0,1370.5604
6590020029,MAGNESIUM SULPHATE 50% INJ -5ML,Medicine,Rayan Hospital,RYN_IP,,,,1170854563,29-04-2024,4.2,-8.4,8546112.0,PCS,Issue to Patient,2.0,2.09887,-4.19773,651.0,1366.36266
6590020029,MAGNESIUM SULPHATE 50% INJ -5ML,Medicine,Rayan Hospital,RYN_IP,,,,1170881704,29-04-2024,4.2,-8.4,8546112.0,PCS,Issue to Patient,2.0,2.09887,-4.19773,649.0,1362.16493
6590020029,MAGNESIUM SULPHATE 50% INJ -5ML,Medicine,Rayan Hospital,RYN_IP,,,,1170932968,29-04-2024,4.2,-16.8,8546112.0,PCS,Issue to Patient,4.0,2.09887,-8.39547,645.0,1353.76946
6590020029,MAGNESIUM SULPHATE 50% INJ -5ML,Medicine,Rayan Hospital,RYN_IP,,,,1170932978,29-04-2024,4.2,-4.2,8546112.0,PCS,Issue to Patient,1.0,2.09887,-2.09887,644.0,1351.67059
6590020029,MAGNESIUM SULPHATE 50% INJ -5ML,Medicine,Rayan Hospital,RYN_IP,,,,1170962160,29-04-2024,4.2,-4.2,8546112.0,PCS,Issue to Patient,1.0,2.09887,-2.09887,643.0,1349.57172
6590020029,MAGNESIUM SULPHATE 50% INJ -5ML,Medicine,Rayan Hospital,RYN_IP,,,,1171247413,30-04-2024,4.2,-16.8,8546112.0,PCS,Issue to Patient,4.0,2.09887,-8.39547,640.0,1343.27512
6590020029,MAGNESIUM SULPHATE 50% INJ -5ML,Medicine,Rayan Hospital,RYN_IP,,,,1171291745,30-04-2024,4.2,-4.2,8546112.0,PCS,Issue to Patient,1.0,2.09887,-2.09887,639.0,1341.17625
6590020029,MAGNESIUM SULPHATE 50% INJ -5ML,Medicine,Rayan Hospital,RYN_IP,,,,1171413296,30-04-2024,2.1,-2.1,8546103.0,PCS,Issue to Patient,1.0,2.09887,-2.09887,638.0,1339.07739
6590020029,MAGNESIUM SULPHATE 50% INJ -5ML,Medicine,Rayan Hospital,RYN_IP,,,,1171415428,30-04-2024,2.1,-2.1,8546103.0,PCS,Issue to Patient,1.0,2.09887,-2.09887,637.0,1336.97852
6590020029,MAGNESIUM SULPHATE 50% INJ -5ML,Medicine,Rayan Hospital,RYN_IP,,,,1171415438,30-04-2024,2.1,-2.1,8546103.0,PCS,Issue to Patient,1.0,2.09887,-2.09887,636.0,1334.87965
6590020029,MAGNESIUM SULPHATE 50% INJ -5ML,Medicine,Rayan Hospital,RYN_IP,,,,1171430617,30-04-2024,4.2,-8.4,8546112.0,PCS,Issue to Patient,2.0,2.09887,-4.19773,634.0,1330.68192
6590020029,MAGNESIUM SULPHATE 50% INJ -5ML,Medicine,Rayan Hospital,RYN_IP,,,,1171752618,30-04-2024,4.2,-8.4,8546112.0,PCS,Issue to Patient,2.0,2.09887,-4.19773,632.0,1326.48418
6590020029,MAGNESIUM SULPHATE 50% INJ -5ML,Medicine,Rayan Hospital,RYN_IP,,,,1171829439,01-05-2024,4.2,-4.2,8546112.0,PCS,Issue to Patient,1.0,2.09887,-2.09887,631.0,1324.38531
6590020029,MAGNESIUM SULPHATE 50% INJ -5ML,Medicine,Rayan Hospital,RYN_IP,,,,1171998015,01-05-2024,2.1,-2.1,8546103.0,PCS,Issue to Patient,1.0,2.09887,-2.09887,630.0,1322.28645
6590020029,MAGNESIUM SULPHATE 50% INJ -5ML,Medicine,Rayan Hospital,STAGE,Rayan Hospital Clinics,RAY_CATHLB,17551313,1172083171,01-05-2024,2.1,-2.1,8546104.0,PCS,Int Order Direct Ship,1.0,2.09887,-2.09887,629.0,1320.18758
6590020029,MAGNESIUM SULPHATE 50% INJ -5ML,Medicine,Rayan Hospital,RYN_IP,,,,1172096325,01-05-2024,4.2,-8.4,8546112.0,PCS,Issue to Patient,2.0,2.09887,-4.19773,627.0,1315.98984
6590020029,MAGNESIUM SULPHATE 50% INJ -5ML,Medicine,Rayan Hospital,RYN_IP,,,,1172126566,01-05-2024,4.2,-16.8,8546112.0,PCS,Issue to Patient,4.0,2.09887,-8.39547,623.0,1307.59438
6590020029,MAGNESIUM SULPHATE 50% INJ -5ML,Medicine,Rayan Hospital,STAGE,Rayan Hospital Clinics,RAY_PTDNWC,17551473,1172139722,01-05-2024,2.1,-8.4,8546104.0,PCS,Int Order Direct Ship,4.0,2.09887,-8.39547,619.0,1299.19891
6590020029,MAGNESIUM SULPHATE 50% INJ -5ML,Medicine,Rayan Hospital,RYN_IP,,,,1172242555,01-05-2024,4.2,-4.2,8546112.0,PCS,Issue to Patient,1.0,2.09887,-2.09887,618.0,1297.10004
6590020029,MAGNESIUM SULPHATE 50% INJ -5ML,Medicine,Rayan Hospital,RYN_IP,,,,1172265575,01-05-2024,4.2,-8.4,8546112.0,PCS,Issue to Patient,2.0,2.09887,-4.19773,616.0,1292.9023
6590020029,MAGNESIUM SULPHATE 50% INJ -5ML,Medicine,Rayan Hospital,RYN_IP,,,,1172273725,01-05-2024,4.2,-8.4,8546112.0,PCS,Issue to Patient,2.0,2.09887,-4.19773,614.0,1288.70457
6590020029,MAGNESIUM SULPHATE 50% INJ -5ML,Medicine,Rayan Hospital,RYN_IP,,,,1172336509,01-05-2024,4.2,-16.8,8546112.0,PCS,Issue to Patient,4.0,2.09887,-8.39547,610.0,1280.3091
6590020029,MAGNESIUM SULPHATE 50% INJ -5ML,Medicine,Rayan Hospital,RYN_IP,,,,1172370813,02-05-2024,2.1,-8.4,8546106.0,PCS,Issue to Patient,4.0,2.09887,-8.39547,606.0,1271.91363
6590020029,MAGNESIUM SULPHATE 50% INJ -5ML,Medicine,Rayan Hospital,RYN_IP,,,,1172447152,02-05-2024,2.1,-2.1,8546111.0,PCS,Issue to Patient,1.0,2.09887,-2.09887,605.0,1269.81476
6590020029,MAGNESIUM SULPHATE 50% INJ -5ML,Medicine,Rayan Hospital,RYN_IP,,,,1172447172,02-05-2024,2.1,-4.2,8546103.0,PCS,Issue to Patient,2.0,2.09887,-4.19773,603.0,1265.61703
6590020029,MAGNESIUM SULPHATE 50% INJ -5ML,Medicine,Rayan Hospital,RYN_IP,,,,1172517240,02-05-2024,4.2,-16.8,8546112.0,PCS,Issue to Patient,4.0,2.09887,-8.39547,599.0,1257.22156
6590020029,MAGNESIUM SULPHATE 50% INJ -5ML,Medicine,Rayan Hospital,RYN_IP,,,,1172552004,02-05-2024,2.1,-4.2,8546106.0,PCS,Issue to Patient,2.0,2.09887,-4.19773,597.0,1253.02382
6590020029,MAGNESIUM SULPHATE 50% INJ -5ML,Medicine,Rayan Hospital,RYN_IP,,,,1172604109,02-05-2024,4.2,-4.2,8546112.0,PCS,Issue to Patient,1.0,2.09887,-2.09887,596.0,1250.92496
6590020029,MAGNESIUM SULPHATE 50% INJ -5ML,Medicine,Rayan Hospital,RYN_IP,,,,1172605709,02-05-2024,4.2,-4.2,8546112.0,PCS,Issue to Patient,1.0,2.09887,-2.09887,595.0,1248.82609
6590020029,MAGNESIUM SULPHATE 50% INJ -5ML,Medicine,Rayan Hospital,RYN_IP,,,,1172681366,02-05-2024,4.2,-8.4,8546112.0,PCS,Issue to Patient,2.0,2.09887,-4.19773,593.0,1244.62835
6590020029,MAGNESIUM SULPHATE 50% INJ -5ML,Medicine,Rayan Hospital,RYN_IP,,,,1172719403,02-05-2024,4.2,-4.2,8546112.0,PCS,Issue to Patient,1.0,2.09887,-2.09887,592.0,1242.52949
6590020029,MAGNESIUM SULPHATE 50% INJ -5ML,Medicine,Rayan Hospital,STAGE,Rayan Hospital Clinics,RAY_TELMET,17551358,1172727124,02-05-2024,2.1,-2.1,8546104.0,PCS,Int Order Direct Ship,1.0,2.09887,-2.09887,591.0,1240.43062
6590020029,MAGNESIUM SULPHATE 50% INJ -5ML,Medicine,Rayan Hospital,RYN_IP,,,,1172927491,03-05-2024,4.2,-8.4,8546112.0,PCS,Issue to Patient,2.0,2.09887,-4.19773,589.0,1236.23288
6590020029,MAGNESIUM SULPHATE 50% INJ -5ML,Medicine,Rayan Hospital,RYN_IP,,,,1172975551,03-05-2024,4.2,-8.4,8546112.0,PCS,Issue to Patient,2.0,2.09887,-4.19773,587.0,1232.03515
6590020029,MAGNESIUM SULPHATE 50% INJ -5ML,Medicine,Rayan Hospital,RYN_IP,,,,1173015346,03-05-2024,4.2,-8.4,8546112.0,PCS,Issue to Patient,2.0,2.09887,-4.19773,585.0,1227.83742
6590020029,MAGNESIUM SULPHATE 50% INJ -5ML,Medicine,Rayan Hospital,RYN_IP,,,,1173025446,03-05-2024,4.2,-8.4,8546112.0,PCS,Issue to Patient,2.0,2.09887,-4.19773,583.0,1223.63968
6590020029,MAGNESIUM SULPHATE 50% INJ -5ML,Medicine,Rayan Hospital,RYN_IP,,,,1173026899,03-05-2024,4.2,-8.4,8546112.0,PCS,Issue to Patient,2.0,2.09887,-4.19773,581.0,1219.44195
6590020029,MAGNESIUM SULPHATE 50% INJ -5ML,Medicine,Rayan Hospital,RYN_IP,,,,1173030010,03-05-2024,4.2,-8.4,8546112.0,PCS,Issue to Patient,2.0,2.09887,-4.19773,579.0,1215.24421
6590020029,MAGNESIUM SULPHATE 50% INJ -5ML,Medicine,Rayan Hospital,RYN_IP,,,,1173052360,03-05-2024,4.2,-8.4,8546112.0,PCS,Issue to Patient,2.0,2.09887,-4.19773,577.0,1211.04648
6590020029,MAGNESIUM SULPHATE 50% INJ -5ML,Medicine,Rayan Hospital,RYN_IP,,,,1173060822,03-05-2024,4.2,-4.2,8546112.0,PCS,Issue to Patient,1.0,2.09887,-2.09887,576.0,1208.94761
6590020029,MAGNESIUM SULPHATE 50% INJ -5ML,Medicine,Rayan Hospital,RYN_IP,,,,1173149903,03-05-2024,4.2,-8.4,8546112.0,PCS,Issue to Patient,2.0,2.09887,-4.19773,574.0,1204.74987
6590020029,MAGNESIUM SULPHATE 50% INJ -5ML,Medicine,Rayan Hospital,RYN_IP,,,,1173208032,04-05-2024,4.2,-4.2,8546112.0,PCS,Issue to Patient,1.0,2.09887,-2.09887,573.0,1202.65101
6590020029,MAGNESIUM SULPHATE 50% INJ -5ML,Medicine,Rayan Hospital,RYN_IP,,,,1173208923,04-05-2024,2.1,-2.1,8546106.0,PCS,Issue to Patient,1.0,2.09887,-2.09887,572.0,1200.55214
6590020029,MAGNESIUM SULPHATE 50% INJ -5ML,Medicine,Rayan Hospital,RYN_IP,,,,1173267309,04-05-2024,4.2,-4.2,8546112.0,PCS,Issue to Patient,1.0,2.09887,-2.09887,571.0,1198.45327
6590020029,MAGNESIUM SULPHATE 50% INJ -5ML,Medicine,Rayan Hospital,RYN_IP,,,,1173333509,04-05-2024,4.2,-8.4,8546112.0,PCS,Issue to Patient,2.0,2.09887,-4.19773,569.0,1194.25554
6590020029,MAGNESIUM SULPHATE 50% INJ -5ML,Medicine,Rayan Hospital,RYN_IP,,,,1173348814,04-05-2024,4.2,-8.4,8546112.0,PCS,Issue to Patient,2.0,2.09887,-4.19773,567.0,1190.0578
6590020029,MAGNESIUM SULPHATE 50% INJ -5ML,Medicine,Rayan Hospital,RYN_IP,,,,1173356412,04-05-2024,4.2,-4.2,8546112.0,PCS,Issue to Patient,1.0,2.09887,-2.09887,566.0,1187.95893
6590020029,MAGNESIUM SULPHATE 50% INJ -5ML,Medicine,Rayan Hospital,RYN_IP,,,,1173436781,04-05-2024,4.2,-4.2,8546112.0,PCS,Issue to Patient,1.0,2.09887,-2.09887,565.0,1185.86007
6590020029,MAGNESIUM SULPHATE 50% INJ -5ML,Medicine,Rayan Hospital,RYN_IP,,,,1173446864,04-05-2024,4.2,-4.2,8546112.0,PCS,Issue to Patient,1.0,2.09887,-2.09887,564.0,1183.7612
6590020029,MAGNESIUM SULPHATE 50% INJ -5ML,Medicine,Rayan Hospital,RYN_IP,,,,1173461955,04-05-2024,4.2,-4.2,8546112.0,PCS,Issue to Patient,1.0,2.09887,-2.09887,563.0,1181.66233
6590020029,MAGNESIUM SULPHATE 50% INJ -5ML,Medicine,Rayan Hospital,RYN_IP,,,,1173733587,04-05-2024,4.2,-4.2,8546112.0,PCS,Issue to Patient,1.0,2.09887,-2.09887,562.0,1179.56347
6590020029,MAGNESIUM SULPHATE 50% INJ -5ML,Medicine,Rayan Hospital,RYN_IP,,,,1173819692,05-05-2024,4.2,-8.4,8546112.0,PCS,Issue to Patient,2.0,2.09887,-4.19773,560.0,1175.36573
6590020029,MAGNESIUM SULPHATE 50% INJ -5ML,Medicine,Rayan Hospital,RYN_IP,,,,1173891937,05-05-2024,2.1,-4.2,8546104.0,PCS,Issue to Patient,2.0,2.09887,-4.19773,558.0,1171.168
6590020029,MAGNESIUM SULPHATE 50% INJ -5ML,Medicine,Rayan Hospital,RYN_IP,,,,1173923643,05-05-2024,4.2,-8.4,8546112.0,PCS,Issue to Patient,2.0,2.09887,-4.19773,556.0,1166.97026
6590020029,MAGNESIUM SULPHATE 50% INJ -5ML,Medicine,Rayan Hospital,RYN_IP,,,,1173965782,05-05-2024,4.2,-8.4,8546112.0,PCS,Issue to Patient,2.0,2.09887,-4.19773,554.0,1162.77253
6590020029,MAGNESIUM SULPHATE 50% INJ -5ML,Medicine,Rayan Hospital,RYN_IP,,,,1174095530,05-05-2024,4.2,-8.4,8546112.0,PCS,Issue to Patient,2.0,2.09887,-4.19773,552.0,1158.57479
6590020029,MAGNESIUM SULPHATE 50% INJ -5ML,Medicine,Rayan Hospital,RYN_IP,,,,1174104586,05-05-2024,4.2,-8.4,8546112.0,PCS,Issue to Patient,2.0,2.09887,-4.19773,550.0,1154.37706
6590020029,MAGNESIUM SULPHATE 50% INJ -5ML,Medicine,Rayan Hospital,RYN_IP,,,,1174106742,05-05-2024,4.2,-8.4,8546112.0,PCS,Issue to Patient,2.0,2.09887,-4.19773,548.0,1150.17932
6590020029,MAGNESIUM SULPHATE 50% INJ -5ML,Medicine,Rayan Hospital,RYN_IP,,,,1174124302,05-05-2024,2.1,-2.1,8546103.0,PCS,Issue to Patient,1.0,2.09887,-2.09887,547.0,1148.08045
6590020029,MAGNESIUM SULPHATE 50% INJ -5ML,Medicine,Rayan Hospital,RYN_IP,,,,1174124352,05-05-2024,2.1,-2.1,8546103.0,PCS,Issue to Patient,1.0,2.09887,-2.09887,546.0,1145.98159
6590020029,MAGNESIUM SULPHATE 50% INJ -5ML,Medicine,Rayan Hospital,RYN_IP,,,,1174254731,05-05-2024,4.2,-4.2,8546112.0,PCS,Issue to Patient,1.0,2.09887,-2.09887,545.0,1143.88272
6590020029,MAGNESIUM SULPHATE 50% INJ -5ML,Medicine,Rayan Hospital,RYN_IP,,,,1174347562,05-05-2024,4.2,-4.2,8546112.0,PCS,Issue to Patient,1.0,2.09887,-2.09887,544.0,1141.78385
6590020029,MAGNESIUM SULPHATE 50% INJ -5ML,Medicine,Rayan Hospital,RYN_IP,,,,1174486068,06-05-2024,4.2,-4.2,8546112.0,PCS,Issue to Patient,1.0,2.09887,-2.09887,543.0,1139.68499
6590020029,MAGNESIUM SULPHATE 50% INJ -5ML,Medicine,Rayan Hospital,RYN_IP,,,,1174710596,06-05-2024,2.1,-2.1,8546104.0,PCS,Issue to Patient,1.0,2.09887,-2.09887,542.0,1137.58612
6590020029,MAGNESIUM SULPHATE 50% INJ -5ML,Medicine,Rayan Hospital,RYN_IP,,,,1174715557,06-05-2024,2.1,-2.1,8546104.0,PCS,Issue to Patient,1.0,2.09887,-2.09887,541.0,1135.48725
6590020029,MAGNESIUM SULPHATE 50% INJ -5ML,Medicine,Rayan Hospital,RYN_IP,,,,1174721253,06-05-2024,4.2,-4.2,8546112.0,PCS,Issue to Patient,1.0,2.09887,-2.09887,540.0,1133.38838
6590020029,MAGNESIUM SULPHATE 50% INJ -5ML,Medicine,Rayan Hospital,RYN_IP,,,,1174850725,06-05-2024,4.2,-4.2,8546112.0,PCS,Issue to Patient,1.0,2.09887,-2.09887,539.0,1131.28952
6590020029,MAGNESIUM SULPHATE 50% INJ -5ML,Medicine,Rayan Hospital,RYN_IP,,,,1174969644,06-05-2024,4.2,-8.4,8546112.0,PCS,Issue to Patient,2.0,2.09887,-4.19773,537.0,1127.09178
6590020029,MAGNESIUM SULPHATE 50% INJ -5ML,Medicine,Rayan Hospital,RYN_IP,,,,1175051983,07-05-2024,4.2,-4.2,8546112.0,PCS,Issue to Patient,1.0,2.09887,-2.09887,536.0,1124.99291
6590020029,MAGNESIUM SULPHATE 50% INJ -5ML,Medicine,Rayan Hospital,RYN_IP,,,,1175054185,07-05-2024,4.2,-4.2,8546112.0,PCS,Issue to Patient,1.0,2.09887,-2.09887,535.0,1122.89405
6590020029,MAGNESIUM SULPHATE 50% INJ -5ML,Medicine,Rayan Hospital,RYN_IP,,,,1175092847,07-05-2024,4.2,-8.4,8546112.0,PCS,Issue to Patient,2.0,2.09887,-4.19773,533.0,1118.69631
6590020029,MAGNESIUM SULPHATE 50% INJ -5ML,Medicine,Rayan Hospital,RYN_IP,,,,1175123775,07-05-2024,4.2,-8.4,8546112.0,PCS,Issue to Patient,2.0,2.09887,-4.19773,531.0,1114.49858
6590020029,MAGNESIUM SULPHATE 50% INJ -5ML,Medicine,Rayan Hospital,RYN_IP,,,,1175142824,07-05-2024,4.2,-4.2,8546112.0,PCS,Issue to Patient,1.0,2.09887,-2.09887,530.0,1112.39971
6590020029,MAGNESIUM SULPHATE 50% INJ -5ML,Medicine,Rayan Hospital,RYN_IP,,,,1175158754,07-05-2024,4.2,-8.4,8546112.0,PCS,Issue to Patient,2.0,2.09887,-4.19773,528.0,1108.20197
6590020029,MAGNESIUM SULPHATE 50% INJ -5ML,Medicine,Rayan Hospital,RYN_IP,,,,1175166412,07-05-2024,4.2,-4.2,8546112.0,PCS,Issue to Patient,1.0,2.09887,-2.09887,527.0,1106.10311
6590020029,MAGNESIUM SULPHATE 50% INJ -5ML,Medicine,Rayan Hospital,RYN_IP,,,,1175168436,07-05-2024,4.2,-4.2,8546112.0,PCS,Issue to Patient,1.0,2.09887,-2.09887,526.0,1104.00424
6590020029,MAGNESIUM SULPHATE 50% INJ -5ML,Medicine,Rayan Hospital,RYN_IP,,,,1175234526,07-05-2024,2.1,-2.1,8546103.0,PCS,Issue to Patient,1.0,2.09887,-2.09887,525.0,1101.90537
6590020029,MAGNESIUM SULPHATE 50% INJ -5ML,Medicine,Rayan Hospital,RYN_IP,,,,1175295509,07-05-2024,4.2,-8.4,8546112.0,PCS,Issue to Patient,2.0,2.09887,-4.19773,523.0,1097.70764
6590020029,MAGNESIUM SULPHATE 50% INJ -5ML,Medicine,Rayan Hospital,RYN_IP,,,,1175719408,08-05-2024,4.2,-4.2,8546112.0,PCS,Issue to Patient,1.0,2.09887,-2.09887,522.0,1095.60877
6590020029,MAGNESIUM SULPHATE 50% INJ -5ML,Medicine,Rayan Hospital,RYN_IP,,,,1175719413,08-05-2024,4.2,-8.4,8546112.0,PCS,Issue to Patient,2.0,2.09887,-4.19773,520.0,1091.41104
6590020029,MAGNESIUM SULPHATE 50% INJ -5ML,Medicine,Rayan Hospital,RYN_IP,,,,1175763720,08-05-2024,4.2,-8.4,8546112.0,PCS,Issue to Patient,2.0,2.09887,-4.19773,518.0,1087.2133
6590020029,MAGNESIUM SULPHATE 50% INJ -5ML,Medicine,Rayan Hospital,RYN_IP,,,,1175824088,08-05-2024,2.1,-4.2,8546103.0,PCS,Issue to Patient,2.0,2.09887,-4.19773,516.0,1083.01557
6590020029,MAGNESIUM SULPHATE 50% INJ -5ML,Medicine,Rayan Hospital,RYN_IP,,,,1175827595,08-05-2024,4.2,-8.4,8546112.0,PCS,Issue to Patient,2.0,2.09887,-4.19773,514.0,1078.81783
6590020029,MAGNESIUM SULPHATE 50% INJ -5ML,Medicine,Rayan Hospital,RYN_IP,,,,1175846214,08-05-2024,2.1,-4.2,8546103.0,PCS,Issue to Patient,2.0,2.09887,-4.19773,512.0,1074.6201
6590020029,MAGNESIUM SULPHATE 50% INJ -5ML,Medicine,Rayan Hospital,RYN_IP,,,,1175847888,08-05-2024,2.1,-2.1,8546103.0,PCS,Issue to Patient,1.0,2.09887,-2.09887,511.0,1072.52123
6590020029,MAGNESIUM SULPHATE 50% INJ -5ML,Medicine,Rayan Hospital,RYN_IP,,,,1175872846,08-05-2024,4.2,-8.4,8546112.0,PCS,Issue to Patient,2.0,2.09887,-4.19773,509.0,1068.32349
6590020029,MAGNESIUM SULPHATE 50% INJ -5ML,Medicine,Rayan Hospital,RYN_IP,,,,1175880005,08-05-2024,2.1,-2.1,8546103.0,PCS,Issue to Patient,1.0,2.09887,-2.09887,508.0,1066.22463
6590020029,MAGNESIUM SULPHATE 50% INJ -5ML,Medicine,Rayan Hospital,RYN_IP,,,,1176283303,09-05-2024,4.2,-8.4,8546112.0,PCS,Issue to Patient,2.0,2.09601,-4.19203,509.0,1066.87064
6590020029,MAGNESIUM SULPHATE 50% INJ -5ML,Medicine,Rayan Hospital,RYN_IP,,,,1176288463,09-05-2024,2.1,-2.1,854683.0,PCS,Issue to Patient,1.0,2.09601,-2.09601,508.0,1064.77463
6590020029,MAGNESIUM SULPHATE 50% INJ -5ML,Medicine,Rayan Hospital,RYN_IP,,,,1176289145,09-05-2024,4.2,-8.4,8546112.0,PCS,Issue to Patient,2.0,2.09601,-4.19203,506.0,1060.5826
6590020029,MAGNESIUM SULPHATE 50% INJ -5ML,Medicine,Rayan Hospital,RYN_IP,,,,1176295873,09-05-2024,4.2,-8.4,8546112.0,PCS,Issue to Patient,2.0,2.09601,-4.19203,504.0,1056.39058
6590020029,MAGNESIUM SULPHATE 50% INJ -5ML,Medicine,Rayan Hospital,RYN_IP,,,,1176341759,09-05-2024,4.2,-4.2,8546112.0,PCS,Issue to Patient,1.0,2.09601,-2.09601,503.0,1054.29456
6590020029,MAGNESIUM SULPHATE 50% INJ -5ML,Medicine,Rayan Hospital,RYN_IP,,,,1176587997,09-05-2024,2.1,-2.1,8546111.0,PCS,Issue to Patient,1.0,2.09601,-2.09601,503.0,1054.29456
6590020029,MAGNESIUM SULPHATE 50% INJ -5ML,Medicine,Rayan Hospital,RYN_IP,,,,1176593796,09-05-2024,4.2,-4.2,8546112.0,PCS,Issue to Patient,1.0,2.09601,-2.09601,502.0,1052.19855
6590020029,MAGNESIUM SULPHATE 50% INJ -5ML,Medicine,Rayan Hospital,RYN_IP,,,,1176597065,09-05-2024,4.2,-4.2,8546112.0,PCS,Issue to Patient,1.0,2.09601,-2.09601,501.0,1050.10254
6590020029,MAGNESIUM SULPHATE 50% INJ -5ML,Medicine,Rayan Hospital,RYN_IP,,,,1176603384,09-05-2024,2.1,-2.1,8546103.0,PCS,Issue to Patient,1.0,2.09601,-2.09601,500.0,1048.00652
6590020029,MAGNESIUM SULPHATE 50% INJ -5ML,Medicine,Rayan Hospital,RYN_IP,,,,1176613174,09-05-2024,2.1,-2.1,8546111.0,PCS,Issue to Patient,1.0,2.09601,-2.09601,499.0,1045.91051
6590020029,MAGNESIUM SULPHATE 50% INJ -5ML,Medicine,Rayan Hospital,RYN_IP,,,,1176617292,09-05-2024,2.1,-2.1,8546111.0,PCS,Issue to Patient,1.0,2.09601,-2.09601,498.0,1043.8145
6590020029,MAGNESIUM SULPHATE 50% INJ -5ML,Medicine,Rayan Hospital,RYN_IP,,,,1176694622,09-05-2024,4.2,-4.2,8546112.0,PCS,Issue to Patient,1.0,2.09601,-2.09601,497.0,1041.71848
6590020029,MAGNESIUM SULPHATE 50% INJ -5ML,Medicine,Rayan Hospital,RYN_IP,,,,1176775179,09-05-2024,4.2,-4.2,8546112.0,PCS,Issue to Patient,1.0,2.09601,-2.09601,496.0,1039.62247
6590020029,MAGNESIUM SULPHATE 50% INJ -5ML,Medicine,Rayan Hospital,RYN_IP,,,,1176786135,09-05-2024,4.2,-4.2,8546112.0,PCS,Issue to Patient,1.0,2.09601,-2.09601,495.0,1037.52646
6590020029,MAGNESIUM SULPHATE 50% INJ -5ML,Medicine,Rayan Hospital,RYN_IP,,,,1176844800,10-05-2024,2.1,-2.1,854683.0,PCS,Issue to Patient,1.0,2.09601,-2.09601,494.0,1035.43045
6590020029,MAGNESIUM SULPHATE 50% INJ -5ML,Medicine,Rayan Hospital,RYN_IP,,,,1176844855,10-05-2024,2.1,-2.1,854683.0,PCS,Issue to Patient,1.0,2.09601,-2.09601,493.0,1033.33443
6590020029,MAGNESIUM SULPHATE 50% INJ -5ML,Medicine,Rayan Hospital,RYN_IP,,,,1176860744,10-05-2024,2.1,-2.1,8546111.0,PCS,Issue to Patient,1.0,2.09601,-2.09601,492.0,1031.23842
6590020029,MAGNESIUM SULPHATE 50% INJ -5ML,Medicine,Rayan Hospital,RYN_IP,,,,1176861669,10-05-2024,4.2,-4.2,8546112.0,PCS,Issue to Patient,1.0,2.09601,-2.09601,491.0,1029.14241
6590020029,MAGNESIUM SULPHATE 50% INJ -5ML,Medicine,Rayan Hospital,RYN_IP,,,,1176863149,10-05-2024,4.2,-8.4,8546112.0,PCS,Issue to Patient,2.0,2.09601,-4.19203,489.0,1024.95038
6590020029,MAGNESIUM SULPHATE 50% INJ -5ML,Medicine,Rayan Hospital,RYN_IP,,,,1176869465,10-05-2024,4.2,-4.2,8546112.0,PCS,Issue to Patient,1.0,2.09601,-2.09601,488.0,1022.85437
6590020029,MAGNESIUM SULPHATE 50% INJ -5ML,Medicine,Rayan Hospital,RYN_IP,,,,1176938792,10-05-2024,4.2,-4.2,8546112.0,PCS,Issue to Patient,1.0,2.09601,-2.09601,487.0,1020.75835
6590020029,MAGNESIUM SULPHATE 50% INJ -5ML,Medicine,Rayan Hospital,RYN_IP,,,,1176940939,10-05-2024,2.1,-2.1,8546111.0,PCS,Issue to Patient,1.0,2.09601,-2.09601,486.0,1018.66234
6590020029,MAGNESIUM SULPHATE 50% INJ -5ML,Medicine,Rayan Hospital,RYN_IP,,,,1176943168,10-05-2024,2.1,-2.1,8546111.0,PCS,Issue to Patient,1.0,2.09601,-2.09601,485.0,1016.56633
6590020029,MAGNESIUM SULPHATE 50% INJ -5ML,Medicine,Rayan Hospital,RYN_IP,,,,1176943998,10-05-2024,2.1,-2.1,8546111.0,PCS,Issue to Patient,1.0,2.09601,-2.09601,484.0,1014.47032
6590020029,MAGNESIUM SULPHATE 50% INJ -5ML,Medicine,Rayan Hospital,RYN_IP,,,,1176945098,10-05-2024,2.1,-2.1,8546111.0,PCS,Issue to Patient,1.0,2.09601,-2.09601,483.0,1012.3743
6590020029,MAGNESIUM SULPHATE 50% INJ -5ML,Medicine,Rayan Hospital,RYN_IP,,,,1177244784,11-05-2024,4.2,-4.2,8546112.0,PCS,Issue to Patient,1.0,2.09601,-2.09601,482.0,1010.27829
6590020029,MAGNESIUM SULPHATE 50% INJ -5ML,Medicine,Rayan Hospital,RYN_IP,,,,1177387615,11-05-2024,2.1,-2.1,8546111.0,PCS,Issue to Patient,1.0,2.09601,-2.09601,481.0,1008.18228
6590020029,MAGNESIUM SULPHATE 50% INJ -5ML,Medicine,Rayan Hospital,RYN_IP,,,,1177392962,11-05-2024,2.1,-2.1,8546111.0,PCS,Issue to Patient,1.0,2.09601,-2.09601,480.0,1006.08626
6590020029,MAGNESIUM SULPHATE 50% INJ -5ML,Medicine,Rayan Hospital,RYN_IP,,,,1177394280,11-05-2024,2.1,-2.1,8546111.0,PCS,Issue to Patient,1.0,2.09601,-2.09601,479.0,1003.99025
6590020029,MAGNESIUM SULPHATE 50% INJ -5ML,Medicine,Rayan Hospital,RYN_IP,,,,1177442601,11-05-2024,4.2,-4.2,8546112.0,PCS,Issue to Patient,1.0,2.09601,-2.09601,478.0,1001.89424
6590020029,MAGNESIUM SULPHATE 50% INJ -5ML,Medicine,Rayan Hospital,RYN_IP,,,,1177645851,11-05-2024,4.2,-4.2,8546112.0,PCS,Issue to Patient,1.0,2.09601,-2.09601,477.0,999.79822
6590020029,MAGNESIUM SULPHATE 50% INJ -5ML,Medicine,Rayan Hospital,RYN_IP,,,,1177699891,12-05-2024,4.2,-8.4,8546112.0,PCS,Issue to Patient,2.0,2.09601,-4.19203,475.0,995.6062
6590020029,MAGNESIUM SULPHATE 50% INJ -5ML,Medicine,Rayan Hospital,RYN_IP,,,,1177719280,12-05-2024,2.1,-2.1,8546111.0,PCS,Issue to Patient,1.0,2.09601,-2.09601,474.0,993.51018
6590020029,MAGNESIUM SULPHATE 50% INJ -5ML,Medicine,Rayan Hospital,RYN_IP,,,,1177732931,12-05-2024,4.2,-8.4,8546112.0,PCS,Issue to Patient,2.0,2.09601,-4.19203,472.0,989.31816
6590020029,MAGNESIUM SULPHATE 50% INJ -5ML,Medicine,Rayan Hospital,RYN_IP,,,,1177787270,12-05-2024,4.2,-8.4,8546112.0,PCS,Issue to Patient,2.0,2.09601,-4.19203,470.0,985.12613
6590020029,MAGNESIUM SULPHATE 50% INJ -5ML,Medicine,Rayan Hospital,RYN_IP,,,,1177830433,12-05-2024,4.2,-4.2,8546112.0,PCS,Issue to Patient,1.0,2.09601,-2.09601,469.0,983.03012
6590020029,MAGNESIUM SULPHATE 50% INJ -5ML,Medicine,Rayan Hospital,RYN_IP,,,,1177838017,12-05-2024,4.2,-4.2,8546112.0,PCS,Issue to Patient,1.0,2.09601,-2.09601,468.0,980.93411
6590020029,MAGNESIUM SULPHATE 50% INJ -5ML,Medicine,Rayan Hospital,RYN_IP,,,,1178053828,12-05-2024,2.1,-2.1,8546103.0,PCS,Issue to Patient,1.0,2.34026,-2.34026,667.0,1560.95472
6590020029,MAGNESIUM SULPHATE 50% INJ -5ML,Medicine,Rayan Hospital,RYN_IP,,,,1178054343,12-05-2024,2.1,-2.1,8546103.0,PCS,Issue to Patient,1.0,2.34026,-2.34026,666.0,1558.61445
6590020029,MAGNESIUM SULPHATE 50% INJ -5ML,Medicine,Rayan Hospital,RYN_IP,,,,1178058262,12-05-2024,4.2,-8.4,8546112.0,PCS,Issue to Patient,2.0,2.34026,-4.68052,664.0,1553.93393
6590020029,MAGNESIUM SULPHATE 50% INJ -5ML,Medicine,Rayan Hospital,RYN_IP,,,,1178061419,12-05-2024,2.1,-2.1,8546103.0,PCS,Issue to Patient,1.0,2.34026,-2.34026,663.0,1551.59367
6590020029,MAGNESIUM SULPHATE 50% INJ -5ML,Medicine,Rayan Hospital,RYN_IP,,,,1178062161,12-05-2024,2.1,-2.1,8546103.0,PCS,Issue to Patient,1.0,2.34026,-2.34026,662.0,1549.25341
6590020029,MAGNESIUM SULPHATE 50% INJ -5ML,Medicine,Rayan Hospital,RYN_IP,,,,1178177028,12-05-2024,4.2,-4.2,8546112.0,PCS,Issue to Patient,1.0,2.34026,-2.34026,661.0,1546.91315
6590020029,MAGNESIUM SULPHATE 50% INJ -5ML,Medicine,Rayan Hospital,RYN_IP,,,,1178201305,12-05-2024,4.2,-8.4,8546112.0,PCS,Issue to Patient,2.0,2.34026,-4.68052,659.0,1542.23262
6590020029,MAGNESIUM SULPHATE 50% INJ -5ML,Medicine,Rayan Hospital,RYN_IP,,,,1178214665,12-05-2024,4.2,-8.4,8546112.0,PCS,Issue to Patient,2.0,2.34026,-4.68052,657.0,1537.5521
6590020029,MAGNESIUM SULPHATE 50% INJ -5ML,Medicine,Rayan Hospital,RYN_IP,,,,1178388911,13-05-2024,4.2,-4.2,8546112.0,PCS,Issue to Patient,1.0,2.34026,-2.34026,656.0,1535.21184
6590020029,MAGNESIUM SULPHATE 50% INJ -5ML,Medicine,Rayan Hospital,RYN_IP,,,,1178388931,13-05-2024,4.2,-8.4,8546112.0,PCS,Issue to Patient,2.0,2.34026,-4.68052,654.0,1530.53131
6590020029,MAGNESIUM SULPHATE 50% INJ -5ML,Medicine,Rayan Hospital,RYN_IP,,,,1178507403,13-05-2024,4.2,-4.2,8546112.0,PCS,Issue to Patient,1.0,2.34026,-2.34026,653.0,1528.19105
6590020029,MAGNESIUM SULPHATE 50% INJ -5ML,Medicine,Rayan Hospital,RYN_IP,,,,1178507496,13-05-2024,4.2,-4.2,8546112.0,PCS,Issue to Patient,1.0,2.34026,-2.34026,652.0,1525.85079
6590020029,MAGNESIUM SULPHATE 50% INJ -5ML,Medicine,Rayan Hospital,RYN_IP,,,,1178514416,13-05-2024,4.2,-4.2,8546112.0,PCS,Issue to Patient,1.0,2.34026,-2.34026,651.0,1523.51053
6590020029,MAGNESIUM SULPHATE 50% INJ -5ML,Medicine,Rayan Hospital,RYN_IP,,,,1178586147,13-05-2024,4.2,-8.4,8546112.0,PCS,Issue to Patient,2.0,2.34026,-4.68052,649.0,1518.83
6590020029,MAGNESIUM SULPHATE 50% INJ -5ML,Medicine,Rayan Hospital,STAGE,Rayan Hospital Clinics,RAY_ER,17592046,1178600779,13-05-2024,2.1,-8.4,8546104.0,PCS,Int Order Direct Ship,4.0,2.34026,-9.36105,645.0,1509.46895
6590020029,MAGNESIUM SULPHATE 50% INJ -5ML,Medicine,Rayan Hospital,RYN_IP,,,,1178604130,13-05-2024,4.2,-8.4,8546112.0,PCS,Issue to Patient,2.0,2.34026,-4.68052,643.0,1504.78843
6590020029,MAGNESIUM SULPHATE 50% INJ -5ML,Medicine,Rayan Hospital,RYN_IP,,,,1178997868,14-05-2024,4.2,-8.4,8546112.0,PCS,Issue to Patient,2.0,2.34026,-4.68052,641.0,1500.10791
6590020029,MAGNESIUM SULPHATE 50% INJ -5ML,Medicine,Rayan Hospital,RYN_IP,,,,1179004360,14-05-2024,4.2,-4.2,8546112.0,PCS,Issue to Patient,1.0,2.34026,-2.34026,640.0,1497.76764
6590020029,MAGNESIUM SULPHATE 50% INJ -5ML,Medicine,Rayan Hospital,RYN_IP,,,,1179031045,14-05-2024,4.2,-8.4,8546112.0,PCS,Issue to Patient,2.0,2.34026,-4.68052,638.0,1493.08712
6590020029,MAGNESIUM SULPHATE 50% INJ -5ML,Medicine,Rayan Hospital,RYN_IP,,,,1179031055,14-05-2024,4.2,-8.4,8546112.0,PCS,Issue to Patient,2.0,2.34026,-4.68052,636.0,1488.4066
6590020029,MAGNESIUM SULPHATE 50% INJ -5ML,Medicine,Rayan Hospital,RYN_IP,,,,1179038305,14-05-2024,4.2,-8.4,8546112.0,PCS,Issue to Patient,2.0,2.34026,-4.68052,634.0,1483.72607
6590020029,MAGNESIUM SULPHATE 50% INJ -5ML,Medicine,Rayan Hospital,RYN_IP,,,,1179091745,14-05-2024,4.2,-4.2,8546112.0,PCS,Issue to Patient,1.0,2.34026,-2.34026,633.0,1481.38581
6590020029,MAGNESIUM SULPHATE 50% INJ -5ML,Medicine,Rayan Hospital,RYN_IP,,,,1179106018,14-05-2024,4.2,-4.2,8546112.0,PCS,Issue to Patient,1.0,2.34026,-2.34026,632.0,1479.04555
6590020029,MAGNESIUM SULPHATE 50% INJ -5ML,Medicine,Rayan Hospital,RYN_IP,,,,1179230315,14-05-2024,4.2,-4.2,8546112.0,PCS,Issue to Patient,1.0,2.34026,-2.34026,631.0,1476.70529
6590020029,MAGNESIUM SULPHATE 50% INJ -5ML,Medicine,Rayan Hospital,RYN_IP,,,,1179249051,14-05-2024,2.1,-2.1,8546103.0,PCS,Issue to Patient,1.0,2.34026,-2.34026,630.0,1474.36502
6590020029,MAGNESIUM SULPHATE 50% INJ -5ML,Medicine,Rayan Hospital,RYN_IP,,,,1179255212,14-05-2024,2.1,-2.1,8546103.0,PCS,Issue to Patient,1.0,2.34026,-2.34026,629.0,1472.02476
6590020029,MAGNESIUM SULPHATE 50% INJ -5ML,Medicine,Rayan Hospital,RYN_IP,,,,1179255217,14-05-2024,2.1,-2.1,8546103.0,PCS,Issue to Patient,1.0,2.34026,-2.34026,628.0,1469.6845
6590020029,MAGNESIUM SULPHATE 50% INJ -5ML,Medicine,Rayan Hospital,RYN_IP,,,,1179655413,15-05-2024,4.2,-8.4,8546112.0,PCS,Issue to Patient,2.0,2.34026,-4.68052,626.0,1465.00398
6590020029,MAGNESIUM SULPHATE 50% INJ -5ML,Medicine,Rayan Hospital,RYN_IP,,,,1179727538,15-05-2024,4.2,-8.4,8546112.0,PCS,Issue to Patient,2.0,2.34026,-4.68052,624.0,1460.32345
6590020029,MAGNESIUM SULPHATE 50% INJ -5ML,Medicine,Rayan Hospital,RYN_IP,,,,1179870059,15-05-2024,2.1,-2.1,8546103.0,PCS,Issue to Patient,1.0,2.34026,-2.34026,623.0,1457.98319
6590020029,MAGNESIUM SULPHATE 50% INJ -5ML,Medicine,Rayan Hospital,RYN_IP,,,,1179872343,15-05-2024,2.1,-2.1,8546111.0,PCS,Issue to Patient,1.0,2.34026,-2.34026,622.0,1455.64293
6590020029,MAGNESIUM SULPHATE 50% INJ -5ML,Medicine,Rayan Hospital,RYN_IP,,,,1179875432,15-05-2024,2.1,-2.1,8546103.0,PCS,Issue to Patient,1.0,2.34026,-2.34026,621.0,1453.30267
6590020029,MAGNESIUM SULPHATE 50% INJ -5ML,Medicine,Rayan Hospital,RYN_IP,,,,1180125374,15-05-2024,4.2,-8.4,8546112.0,PCS,Issue to Patient,2.0,2.34026,-4.68052,619.0,1448.62214
6590020029,MAGNESIUM SULPHATE 50% INJ -5ML,Medicine,Rayan Hospital,RYN_IP,,,,1180343432,16-05-2024,4.2,-4.2,8546112.0,PCS,Issue to Patient,1.0,2.34026,-2.34026,618.0,1446.28188
6590020029,MAGNESIUM SULPHATE 50% INJ -5ML,Medicine,Rayan Hospital,RYN_IP,,,,1180404589,16-05-2024,4.2,-8.4,8546112.0,PCS,Issue to Patient,2.0,2.34026,-4.68052,616.0,1441.60136
6590020029,MAGNESIUM SULPHATE 50% INJ -5ML,Medicine,Rayan Hospital,RYN_IP,,,,1180415901,16-05-2024,4.2,-8.4,8546112.0,PCS,Issue to Patient,2.0,2.34026,-4.68052,614.0,1436.92083
6590020029,MAGNESIUM SULPHATE 50% INJ -5ML,Medicine,Rayan Hospital,RYN_IP,,,,1180503085,16-05-2024,2.1,-2.1,8546103.0,PCS,Issue to Patient,1.0,2.34026,-2.34026,615.0,1439.2611
6590020029,MAGNESIUM SULPHATE 50% INJ -5ML,Medicine,Rayan Hospital,RYN_IP,,,,1180512759,16-05-2024,4.2,-8.4,8546112.0,PCS,Issue to Patient,2.0,2.34026,-4.68052,613.0,1434.58057
6590020029,MAGNESIUM SULPHATE 50% INJ -5ML,Medicine,Rayan Hospital,RYN_IP,,,,1180607227,16-05-2024,4.2,-8.4,8546112.0,PCS,Issue to Patient,2.0,2.34026,-4.68052,611.0,1429.90005
6590020029,MAGNESIUM SULPHATE 50% INJ -5ML,Medicine,Rayan Hospital,RYN_IP,,,,1180879443,17-05-2024,4.2,-4.2,8546112.0,PCS,Issue to Patient,1.0,2.34026,-2.34026,610.0,1427.55979
6590020029,MAGNESIUM SULPHATE 50% INJ -5ML,Medicine,Rayan Hospital,RYN_IP,,,,1180913962,17-05-2024,4.2,-8.4,8546112.0,PCS,Issue to Patient,2.0,2.34026,-4.68052,608.0,1422.87926
6590020029,MAGNESIUM SULPHATE 50% INJ -5ML,Medicine,Rayan Hospital,RYN_IP,,,,1180939189,17-05-2024,4.2,-8.4,8546112.0,PCS,Issue to Patient,2.0,2.34026,-4.68052,606.0,1418.19874
6590020029,MAGNESIUM SULPHATE 50% INJ -5ML,Medicine,Rayan Hospital,RYN_IP,,,,1180960641,17-05-2024,4.2,-8.4,8546112.0,PCS,Issue to Patient,2.0,2.34026,-4.68052,604.0,1413.51821
6590020029,MAGNESIUM SULPHATE 50% INJ -5ML,Medicine,Rayan Hospital,RYN_IP,,,,1180992922,17-05-2024,4.2,-8.4,8546112.0,PCS,Issue to Patient,2.0,2.34026,-4.68052,602.0,1408.83769
6590020029,MAGNESIUM SULPHATE 50% INJ -5ML,Medicine,Rayan Hospital,RYN_IP,,,,1181011972,17-05-2024,4.2,-8.4,8546112.0,PCS,Issue to Patient,2.0,2.34026,-4.68052,600.0,1404.15717
6590020029,MAGNESIUM SULPHATE 50% INJ -5ML,Medicine,Rayan Hospital,RYN_IP,,,,1181021918,17-05-2024,2.1,-2.1,8546103.0,PCS,Issue to Patient,1.0,2.34026,-2.34026,599.0,1401.8169
6590020029,MAGNESIUM SULPHATE 50% INJ -5ML,Medicine,Rayan Hospital,RYN_IP,,,,1181023934,17-05-2024,2.1,-2.1,8546104.0,PCS,Issue to Patient,1.0,2.34026,-2.34026,598.0,1399.47664
6590020029,MAGNESIUM SULPHATE 50% INJ -5ML,Medicine,Rayan Hospital,RYN_IP,,,,1181036256,17-05-2024,4.2,-4.2,8546112.0,PCS,Issue to Patient,1.0,2.34026,-2.34026,597.0,1397.13638
6590020029,MAGNESIUM SULPHATE 50% INJ -5ML,Medicine,Rayan Hospital,RYN_IP,,,,1181058574,17-05-2024,4.2,-4.2,8546112.0,PCS,Issue to Patient,1.0,2.34026,-2.34026,596.0,1394.79612
6590020029,MAGNESIUM SULPHATE 50% INJ -5ML,Medicine,Rayan Hospital,RYN_IP,,,,1181145014,18-05-2024,4.2,-4.2,8546112.0,PCS,Issue to Patient,1.0,2.34026,-2.34026,595.0,1392.45586
6590020029,MAGNESIUM SULPHATE 50% INJ -5ML,Medicine,Rayan Hospital,RYN_IP,,,,1181164241,18-05-2024,4.2,-4.2,8546112.0,PCS,Issue to Patient,1.0,2.34026,-2.34026,594.0,1390.11559
6590020029,MAGNESIUM SULPHATE 50% INJ -5ML,Medicine,Rayan Hospital,RYN_IP,,,,1181229916,18-05-2024,4.2,-8.4,8546112.0,PCS,Issue to Patient,2.0,2.34026,-4.68052,592.0,1385.43507
6590020029,MAGNESIUM SULPHATE 50% INJ -5ML,Medicine,Rayan Hospital,RYN_IP,,,,1181257016,18-05-2024,4.2,-8.4,8546112.0,PCS,Issue to Patient,2.0,2.34026,-4.68052,590.0,1380.75455
6590020029,MAGNESIUM SULPHATE 50% INJ -5ML,Medicine,Rayan Hospital,RYN_IP,,,,1181257252,18-05-2024,4.2,-8.4,8546112.0,PCS,Issue to Patient,2.0,2.34026,-4.68052,588.0,1376.07402
6590020029,MAGNESIUM SULPHATE 50% INJ -5ML,Medicine,Rayan Hospital,RYN_IP,,,,1181273748,18-05-2024,4.2,-8.4,8546112.0,PCS,Issue to Patient,2.0,2.34026,-4.68052,586.0,1371.3935
6590020029,MAGNESIUM SULPHATE 50% INJ -5ML,Medicine,Rayan Hospital,RYN_IP,,,,1181288172,18-05-2024,4.2,-8.4,8546112.0,PCS,Issue to Patient,2.0,2.34026,-4.68052,584.0,1366.71298
6590020029,MAGNESIUM SULPHATE 50% INJ -5ML,Medicine,Rayan Hospital,RYN_IP,,,,1181351369,18-05-2024,4.2,-4.2,8546112.0,PCS,Issue to Patient,1.0,2.34026,-2.34026,583.0,1364.37271
6590020029,MAGNESIUM SULPHATE 50% INJ -5ML,Medicine,Rayan Hospital,RYN_IP,,,,1181351794,18-05-2024,4.2,-4.2,8546112.0,PCS,Issue to Patient,1.0,2.34026,-2.34026,582.0,1362.03245
6590020029,MAGNESIUM SULPHATE 50% INJ -5ML,Medicine,Rayan Hospital,RYN_IP,,,,1181362739,18-05-2024,4.2,-4.2,8546112.0,PCS,Issue to Patient,1.0,2.34026,-2.34026,581.0,1359.69219
6590020029,MAGNESIUM SULPHATE 50% INJ -5ML,Medicine,Rayan Hospital,RYN_IP,,,,1181825570,19-05-2024,4.2,-8.4,8546112.0,PCS,Issue to Patient,2.0,2.34026,-4.68052,579.0,1355.01167
6590020029,MAGNESIUM SULPHATE 50% INJ -5ML,Medicine,Rayan Hospital,RYN_IP,,,,1181826395,19-05-2024,4.2,-8.4,8546112.0,PCS,Issue to Patient,2.0,2.34026,-4.68052,577.0,1350.33114
6590020029,MAGNESIUM SULPHATE 50% INJ -5ML,Medicine,Rayan Hospital,RYN_IP,,,,1181860908,19-05-2024,4.2,-8.4,8546112.0,PCS,Issue to Patient,2.0,2.34026,-4.68052,575.0,1345.65062
6590020029,MAGNESIUM SULPHATE 50% INJ -5ML,Medicine,Rayan Hospital,RYN_IP,,,,1182002583,19-05-2024,4.2,-8.4,8546112.0,PCS,Issue to Patient,2.0,2.34026,-4.68052,573.0,1340.97009
6590020029,MAGNESIUM SULPHATE 50% INJ -5ML,Medicine,Rayan Hospital,RYN_IP,,,,1182002633,19-05-2024,4.2,-8.4,8546112.0,PCS,Issue to Patient,2.0,2.34026,-4.68052,571.0,1336.28957
6590020029,MAGNESIUM SULPHATE 50% INJ -5ML,Medicine,Rayan Hospital,RYN_IP,,,,1182082617,19-05-2024,2.1,-2.1,8546111.0,PCS,Issue to Patient,1.0,2.34026,-2.34026,570.0,1333.94931
6590020029,MAGNESIUM SULPHATE 50% INJ -5ML,Medicine,Rayan Hospital,RYN_IP,,,,1182438164,20-05-2024,4.2,-8.4,8546112.0,PCS,Issue to Patient,2.0,2.34026,-4.68052,568.0,1329.26878
6590020029,MAGNESIUM SULPHATE 50% INJ -5ML,Medicine,Rayan Hospital,RYN_IP,,,,1182495018,20-05-2024,4.2,-8.4,8546112.0,PCS,Issue to Patient,2.0,2.34026,-4.68052,566.0,1324.58826
6590020029,MAGNESIUM SULPHATE 50% INJ -5ML,Medicine,Rayan Hospital,RYN_IP,,,,1182657898,20-05-2024,4.2,-8.4,8546112.0,PCS,Issue to Patient,2.0,2.34026,-4.68052,564.0,1319.90774
6590020029,MAGNESIUM SULPHATE 50% INJ -5ML,Medicine,Rayan Hospital,RYN_IP,,,,1182677355,20-05-2024,4.2,-4.2,8546112.0,PCS,Issue to Patient,1.0,2.34026,-2.34026,563.0,1317.56747
6590020029,MAGNESIUM SULPHATE 50% INJ -5ML,Medicine,Rayan Hospital,RYN_IP,,,,1182680794,20-05-2024,4.2,-4.2,8546112.0,PCS,Issue to Patient,1.0,2.34026,-2.34026,562.0,1315.22721
6590020029,MAGNESIUM SULPHATE 50% INJ -5ML,Medicine,Rayan Hospital,RYN_IP,,,,1182685354,20-05-2024,2.1,-4.2,8546103.0,PCS,Issue to Patient,2.0,2.34026,-4.68052,560.0,1310.54669
6590020029,MAGNESIUM SULPHATE 50% INJ -5ML,Medicine,Rayan Hospital,RYN_IP,,,,1182694793,20-05-2024,4.2,-4.2,8546112.0,PCS,Issue to Patient,1.0,2.34026,-2.34026,559.0,1308.20643
6590020029,MAGNESIUM SULPHATE 50% INJ -5ML,Medicine,Rayan Hospital,RYN_IP,,,,1182811734,20-05-2024,4.2,-4.2,8546112.0,PCS,Issue to Patient,1.0,2.34026,-2.34026,558.0,1305.86616
6590020029,MAGNESIUM SULPHATE 50% INJ -5ML,Medicine,Rayan Hospital,RYN_IP,,,,1182944018,20-05-2024,4.2,-8.4,8546112.0,PCS,Issue to Patient,2.0,2.34026,-4.68052,556.0,1301.18564
6590020029,MAGNESIUM SULPHATE 50% INJ -5ML,Medicine,Rayan Hospital,RYN_IP,,,,1183068497,20-05-2024,4.2,-4.2,8546112.0,PCS,Issue to Patient,1.0,2.34026,-2.34026,555.0,1298.84538
6590020029,MAGNESIUM SULPHATE 50% INJ -5ML,Medicine,Rayan Hospital,RYN_IP,,,,1183068677,20-05-2024,4.2,-4.2,8546112.0,PCS,Issue to Patient,1.0,2.34026,-2.34026,554.0,1296.50512
6590020029,MAGNESIUM SULPHATE 50% INJ -5ML,Medicine,Rayan Hospital,RYN_IP,,,,1183070150,20-05-2024,4.2,-4.2,8546112.0,PCS,Issue to Patient,1.0,2.34026,-2.34026,553.0,1294.16486
6590020029,MAGNESIUM SULPHATE 50% INJ -5ML,Medicine,Rayan Hospital,RYN_IP,,,,1183101394,21-05-2024,4.2,-4.2,8546112.0,PCS,Issue to Patient,1.0,2.34026,-2.34026,552.0,1291.82459
6590020029,MAGNESIUM SULPHATE 50% INJ -5ML,Medicine,Rayan Hospital,RYN_IP,,,,1183180202,21-05-2024,4.2,-8.4,8546112.0,PCS,Issue to Patient,2.0,2.34026,-4.68052,550.0,1287.14407
6590020029,MAGNESIUM SULPHATE 50% INJ -5ML,Medicine,Rayan Hospital,RYN_IP,,,,1183192813,21-05-2024,4.2,-8.4,8546112.0,PCS,Issue to Patient,2.0,2.34026,-4.68052,548.0,1282.46355
6590020029,MAGNESIUM SULPHATE 50% INJ -5ML,Medicine,Rayan Hospital,RYN_IP,,,,1183200084,21-05-2024,4.2,-4.2,8546112.0,PCS,Issue to Patient,1.0,2.34026,-2.34026,547.0,1280.12328
6590020029,MAGNESIUM SULPHATE 50% INJ -5ML,Medicine,Rayan Hospital,RYN_IP,,,,1183331873,21-05-2024,2.1,-2.1,8546103.0,PCS,Issue to Patient,1.0,2.34026,-2.34026,546.0,1277.78302
6590020029,MAGNESIUM SULPHATE 50% INJ -5ML,Medicine,Rayan Hospital,RYN_IP,,,,1183331887,21-05-2024,2.1,-2.1,8546106.0,PCS,Issue to Patient,1.0,2.34026,-2.34026,545.0,1275.44276
6590020029,MAGNESIUM SULPHATE 50% INJ -5ML,Medicine,Rayan Hospital,RYN_IP,,,,1183334757,21-05-2024,2.1,-2.1,8546103.0,PCS,Issue to Patient,1.0,2.34026,-2.34026,544.0,1273.1025
6590020029,MAGNESIUM SULPHATE 50% INJ -5ML,Medicine,Rayan Hospital,RYN_IP,,,,1183337997,21-05-2024,2.1,-2.1,8546103.0,PCS,Issue to Patient,1.0,2.34026,-2.34026,543.0,1270.76224
6590020029,MAGNESIUM SULPHATE 50% INJ -5ML,Medicine,Rayan Hospital,RYN_IP,,,,1183338027,21-05-2024,2.1,-2.1,8546103.0,PCS,Issue to Patient,1.0,2.34026,-2.34026,542.0,1268.42197
6590020029,MAGNESIUM SULPHATE 50% INJ -5ML,Medicine,Rayan Hospital,STAGE,Rayan Hospital Clinics,RAY_ER,17625493,1183510472,21-05-2024,2.1,-10.5,8546104.0,PCS,Int Order Direct Ship,5.0,2.34026,-11.70131,537.0,1256.72066
6590020029,MAGNESIUM SULPHATE 50% INJ -5ML,Medicine,Rayan Hospital,RYN_IP,,,,1183760382,22-05-2024,4.2,-4.2,8546112.0,PCS,Issue to Patient,1.0,2.34026,-2.34026,536.0,1254.3804
6590020029,MAGNESIUM SULPHATE 50% INJ -5ML,Medicine,Rayan Hospital,RYN_IP,,,,1183804545,22-05-2024,4.2,-4.2,8546112.0,PCS,Issue to Patient,1.0,2.34026,-2.34026,535.0,1252.04014
6590020029,MAGNESIUM SULPHATE 50% INJ -5ML,Medicine,Rayan Hospital,RYN_IP,,,,1183816885,22-05-2024,4.2,-4.2,8546112.0,PCS,Issue to Patient,1.0,2.34026,-2.34026,534.0,1249.69988
6590020029,MAGNESIUM SULPHATE 50% INJ -5ML,Medicine,Rayan Hospital,RYN_IP,,,,1183869462,22-05-2024,4.2,-4.2,8546112.0,PCS,Issue to Patient,1.0,2.34026,-2.34026,533.0,1247.35962
6590020029,MAGNESIUM SULPHATE 50% INJ -5ML,Medicine,Rayan Hospital,RYN_IP,,,,1183894345,22-05-2024,4.2,-4.2,8546112.0,PCS,Issue to Patient,1.0,2.34026,-2.34026,532.0,1245.01935
6590020029,MAGNESIUM SULPHATE 50% INJ -5ML,Medicine,Rayan Hospital,STAGE,Rayan Hospital Clinics,RAY_ANSTHA,17625841,1183938028,22-05-2024,2.1,-29.4,8546104.0,PCS,Int Order Direct Ship,14.0,2.34026,-32.76367,518.0,1212.25569
6590020029,MAGNESIUM SULPHATE 50% INJ -5ML,Medicine,Rayan Hospital,STAGE,Rayan Hospital Clinics,RAY_ANSTHA,17625841,1183938030,22-05-2024,2.1,-2.1,8546106.0,PCS,Int Order Direct Ship,1.0,2.34026,-2.34026,517.0,1209.91543
6590020029,MAGNESIUM SULPHATE 50% INJ -5ML,Medicine,Rayan Hospital,RYN_IP,,,,1183960560,22-05-2024,4.2,-4.2,8546112.0,PCS,Issue to Patient,1.0,2.34026,-2.34026,516.0,1207.57516
6590020029,MAGNESIUM SULPHATE 50% INJ -5ML,Medicine,Rayan Hospital,RYN_IP,,,,1183972179,22-05-2024,4.2,-4.2,8546112.0,PCS,Issue to Patient,1.0,2.34026,-2.34026,515.0,1205.2349
6590020029,MAGNESIUM SULPHATE 50% INJ -5ML,Medicine,Rayan Hospital,RYN_IP,,,,1183976755,22-05-2024,2.1,-2.1,8546103.0,PCS,Issue to Patient,1.0,2.34026,-2.34026,514.0,1202.89464
6590020029,MAGNESIUM SULPHATE 50% INJ -5ML,Medicine,Rayan Hospital,RYN_IP,,,,1184026284,22-05-2024,4.2,-8.4,8546112.0,PCS,Issue to Patient,2.0,2.34026,-4.68052,512.0,1198.21412
6590020029,MAGNESIUM SULPHATE 50% INJ -5ML,Medicine,Rayan Hospital,RYN_IP,,,,1184083901,22-05-2024,2.1,-2.1,8546103.0,PCS,Issue to Patient,1.0,2.34026,-2.34026,511.0,1195.87385
6590020029,MAGNESIUM SULPHATE 50% INJ -5ML,Medicine,Rayan Hospital,RYN_IP,,,,1184094513,22-05-2024,2.1,-2.1,8546103.0,PCS,Issue to Patient,1.0,2.34026,-2.34026,510.0,1193.53359
6590020029,MAGNESIUM SULPHATE 50% INJ -5ML,Medicine,Rayan Hospital,RYN_IP,,,,1184208623,22-05-2024,4.2,-4.2,8546112.0,PCS,Issue to Patient,1.0,2.34026,-2.34026,509.0,1191.19333
6590020029,MAGNESIUM SULPHATE 50% INJ -5ML,Medicine,Rayan Hospital,RYN_IP,,,,1184353356,23-05-2024,4.2,-8.4,8546112.0,PCS,Issue to Patient,2.0,2.34026,-4.68052,507.0,1186.51281
6590020029,MAGNESIUM SULPHATE 50% INJ -5ML,Medicine,Rayan Hospital,RYN_IP,,,,1184430371,23-05-2024,4.2,-4.2,8546112.0,PCS,Issue to Patient,1.0,2.34026,-2.34026,506.0,1184.17254
6590020029,MAGNESIUM SULPHATE 50% INJ -5ML,Medicine,Rayan Hospital,RYN_IP,,,,1184549337,23-05-2024,2.1,-2.1,8546103.0,PCS,Issue to Patient,1.0,2.34026,-2.34026,505.0,1181.83228
6590020029,MAGNESIUM SULPHATE 50% INJ -5ML,Medicine,Rayan Hospital,RYN_IP,,,,1184552137,23-05-2024,2.1,-2.1,8546103.0,PCS,Issue to Patient,1.0,2.34026,-2.34026,504.0,1179.49202
6590020029,MAGNESIUM SULPHATE 50% INJ -5ML,Medicine,Rayan Hospital,RYN_IP,,,,1184556334,23-05-2024,2.1,-2.1,8546103.0,PCS,Issue to Patient,1.0,2.34026,-2.34026,503.0,1177.15176
6590020029,MAGNESIUM SULPHATE 50% INJ -5ML,Medicine,Rayan Hospital,RYN_IP,,,,1184827356,23-05-2024,4.2,-4.2,8546112.0,PCS,Issue to Patient,1.0,2.34026,-2.34026,502.0,1174.8115
6590020029,MAGNESIUM SULPHATE 50% INJ -5ML,Medicine,Rayan Hospital,RYN_IP,,,,1184880315,23-05-2024,4.2,-8.4,8546112.0,PCS,Issue to Patient,2.0,2.34026,-4.68052,500.0,1170.13097
6590020029,MAGNESIUM SULPHATE 50% INJ -5ML,Medicine,Rayan Hospital,RYN_IP,,,,1184903522,24-05-2024,4.2,-8.4,8546112.0,PCS,Issue to Patient,2.0,2.34026,-4.68052,498.0,1165.45045
6590020029,MAGNESIUM SULPHATE 50% INJ -5ML,Medicine,Rayan Hospital,RYN_IP,,,,1184952884,24-05-2024,4.2,-8.4,8546112.0,PCS,Issue to Patient,2.0,2.34026,-4.68052,496.0,1160.76992
6590020029,MAGNESIUM SULPHATE 50% INJ -5ML,Medicine,Rayan Hospital,RYN_IP,,,,1184965832,24-05-2024,4.2,-8.4,8546112.0,PCS,Issue to Patient,2.0,2.34026,-4.68052,494.0,1156.0894
6590020029,MAGNESIUM SULPHATE 50% INJ -5ML,Medicine,Rayan Hospital,RYN_IP,,,,1184966599,24-05-2024,4.2,-8.4,8546112.0,PCS,Issue to Patient,2.0,2.34026,-4.68052,492.0,1151.40888
6590020029,MAGNESIUM SULPHATE 50% INJ -5ML,Medicine,Rayan Hospital,RYN_IP,,,,1184991794,24-05-2024,4.2,-8.4,8546112.0,PCS,Issue to Patient,2.0,2.34026,-4.68052,490.0,1146.72835
6590020029,MAGNESIUM SULPHATE 50% INJ -5ML,Medicine,Rayan Hospital,RYN_IP,,,,1184995595,24-05-2024,4.2,-8.4,8546112.0,PCS,Issue to Patient,2.0,2.34026,-4.68052,488.0,1142.04783
6590020029,MAGNESIUM SULPHATE 50% INJ -5ML,Medicine,Rayan Hospital,RYN_IP,,,,1185009446,24-05-2024,4.2,-8.4,8546112.0,PCS,Issue to Patient,2.0,2.34026,-4.68052,486.0,1137.3673
6590020029,MAGNESIUM SULPHATE 50% INJ -5ML,Medicine,Rayan Hospital,RYN_IP,,,,1185014356,24-05-2024,2.1,-2.1,8546104.0,PCS,Issue to Patient,1.0,2.34026,-2.34026,485.0,1135.02704
6590020029,MAGNESIUM SULPHATE 50% INJ -5ML,Medicine,Rayan Hospital,RYN_IP,,,,1185015672,24-05-2024,2.1,-2.1,8546104.0,PCS,Issue to Patient,1.0,2.34026,-2.34026,484.0,1132.68678
6590020029,MAGNESIUM SULPHATE 50% INJ -5ML,Medicine,Rayan Hospital,RYN_IP,,,,1185079321,24-05-2024,4.2,-8.4,8546112.0,PCS,Issue to Patient,2.0,2.34026,-4.68052,482.0,1128.00626
6590020029,MAGNESIUM SULPHATE 50% INJ -5ML,Medicine,Rayan Hospital,RYN_IP,,,,1185100584,24-05-2024,4.2,-16.8,8546112.0,PCS,Issue to Patient,4.0,2.34026,-9.36105,478.0,1118.64521
6590020029,MAGNESIUM SULPHATE 50% INJ -5ML,Medicine,Rayan Hospital,RYN_IP,,,,1185129009,24-05-2024,4.2,-4.2,8546112.0,PCS,Issue to Patient,1.0,2.34026,-2.34026,477.0,1116.30495
6590020029,MAGNESIUM SULPHATE 50% INJ -5ML,Medicine,Rayan Hospital,RYN_IP,,,,1185173263,25-05-2024,4.2,-16.8,8546112.0,PCS,Issue to Patient,4.0,2.34026,-9.36105,473.0,1106.9439
6590020029,MAGNESIUM SULPHATE 50% INJ -5ML,Medicine,Rayan Hospital,RYN_IP,,,,1185189291,25-05-2024,4.2,-4.2,8546112.0,PCS,Issue to Patient,1.0,2.34026,-2.34026,472.0,1104.60364
6590020029,MAGNESIUM SULPHATE 50% INJ -5ML,Medicine,Rayan Hospital,RYN_IP,,,,1185202163,25-05-2024,4.2,-8.4,8546112.0,PCS,Issue to Patient,2.0,2.34026,-4.68052,470.0,1099.92311
6590020029,MAGNESIUM SULPHATE 50% INJ -5ML,Medicine,Rayan Hospital,RYN_IP,,,,1185202798,25-05-2024,4.2,-4.2,8546112.0,PCS,Issue to Patient,1.0,2.34026,-2.34026,469.0,1097.58285
6590020029,MAGNESIUM SULPHATE 50% INJ -5ML,Medicine,Rayan Hospital,RYN_IP,Rayan Main Pharmacy,RYN_MP,RAY28996,1185226846,25-05-2024,4.2,-378.0,8546112.0,PCS,Intransit Shipment,90.0,2.34026,-210.62357,379.0,886.95928
6590020029,MAGNESIUM SULPHATE 50% INJ -5ML,Medicine,Rayan Hospital,RYN_IP,,,,1185244132,25-05-2024,4.2,-8.4,8546112.0,PCS,Issue to Patient,2.0,2.34026,-4.68052,377.0,882.27875
6590020029,MAGNESIUM SULPHATE 50% INJ -5ML,Medicine,Rayan Hospital,RYN_IP,,,,1185269450,25-05-2024,4.2,-8.4,8546112.0,PCS,Issue to Patient,2.0,2.34026,-4.68052,375.0,877.59823
6590020029,MAGNESIUM SULPHATE 50% INJ -5ML,Medicine,Rayan Hospital,RYN_IP,,,,1185317535,25-05-2024,2.1,-2.1,8546104.0,PCS,Issue to Patient,1.0,2.34026,-2.34026,374.0,875.25797
6590020029,MAGNESIUM SULPHATE 50% INJ -5ML,Medicine,Rayan Hospital,RYN_IP,,,,1185320730,25-05-2024,2.1,-2.1,8546104.0,PCS,Issue to Patient,1.0,2.34026,-2.34026,373.0,872.91771
6590020029,MAGNESIUM SULPHATE 50% INJ -5ML,Medicine,Rayan Hospital,RYN_IP,,,,1185624353,25-05-2024,4.2,-8.4,8546112.0,PCS,Issue to Patient,2.0,2.34026,-4.68052,371.0,868.23718
6590020029,MAGNESIUM SULPHATE 50% INJ -5ML,Medicine,Rayan Hospital,RYN_IP,,,,1185781551,26-05-2024,4.2,-4.2,8546112.0,PCS,Issue to Patient,1.0,2.34026,-2.34026,370.0,865.89692
6590020029,MAGNESIUM SULPHATE 50% INJ -5ML,Medicine,Rayan Hospital,RYN_IP,,,,1185792441,26-05-2024,4.2,-4.2,8546112.0,PCS,Issue to Patient,1.0,2.34026,-2.34026,369.0,863.55666
6590020029,MAGNESIUM SULPHATE 50% INJ -5ML,Medicine,Rayan Hospital,RYN_IP,,,,1185803077,26-05-2024,4.2,-4.2,8546112.0,PCS,Issue to Patient,1.0,2.34026,-2.34026,368.0,861.2164
6590020029,MAGNESIUM SULPHATE 50% INJ -5ML,Medicine,Rayan Hospital,RYN_IP,,,,1185810980,26-05-2024,4.2,-8.4,8546112.0,PCS,Issue to Patient,2.0,2.34026,-4.68052,366.0,856.53587
6590020029,MAGNESIUM SULPHATE 50% INJ -5ML,Medicine,Rayan Hospital,RYN_IP,,,,1185845016,26-05-2024,4.2,-4.2,8546112.0,PCS,Issue to Patient,1.0,2.34026,-2.34026,365.0,854.19561
6590020029,MAGNESIUM SULPHATE 50% INJ -5ML,Medicine,Rayan Hospital,RYN_IP,,,,1185851938,26-05-2024,4.2,-4.2,8546112.0,PCS,Issue to Patient,1.0,2.34026,-2.34026,364.0,851.85535
6590020029,MAGNESIUM SULPHATE 50% INJ -5ML,Medicine,Rayan Hospital,RYN_IP,,,,1185853743,26-05-2024,4.2,-4.2,8546112.0,PCS,Issue to Patient,1.0,2.34026,-2.34026,363.0,849.51509
6590020029,MAGNESIUM SULPHATE 50% INJ -5ML,Medicine,Rayan Hospital,RYN_IP,,,,1185857729,26-05-2024,4.2,-8.4,8546112.0,PCS,Issue to Patient,2.0,2.34026,-4.68052,361.0,844.83456
6590020029,MAGNESIUM SULPHATE 50% INJ -5ML,Medicine,Rayan Hospital,RYN_IP,,,,1185865937,26-05-2024,4.2,-8.4,8546112.0,PCS,Issue to Patient,2.0,2.34026,-4.68052,359.0,840.15404
6590020029,MAGNESIUM SULPHATE 50% INJ -5ML,Medicine,Rayan Hospital,RYN_IP,,,,1185931865,26-05-2024,4.2,-8.4,8546112.0,PCS,Issue to Patient,2.0,2.34026,-4.68052,357.0,835.47351
6590020029,MAGNESIUM SULPHATE 50% INJ -5ML,Medicine,Rayan Hospital,RYN_IP,,,,1185950616,26-05-2024,2.1,-2.1,8546103.0,PCS,Issue to Patient,1.0,2.34026,-2.34026,356.0,833.13325
6590020029,MAGNESIUM SULPHATE 50% INJ -5ML,Medicine,Rayan Hospital,RYN_IP,,,,1185966936,26-05-2024,2.1,-2.1,8546104.0,PCS,Issue to Patient,1.0,2.34026,-2.34026,355.0,830.79299
6590020029,MAGNESIUM SULPHATE 50% INJ -5ML,Medicine,Rayan Hospital,RYN_IP,,,,1185970074,26-05-2024,2.1,-2.1,8546104.0,PCS,Issue to Patient,1.0,2.34026,-2.34026,354.0,828.45273
6590020029,MAGNESIUM SULPHATE 50% INJ -5ML,Medicine,Rayan Hospital,RYN_IP,,,,1186325875,26-05-2024,4.2,-16.8,8546112.0,PCS,Issue to Patient,4.0,2.34026,-9.36105,350.0,819.09168
6590020029,MAGNESIUM SULPHATE 50% INJ -5ML,Medicine,Rayan Hospital,RYN_IP,,,,1186390710,27-05-2024,4.2,-8.4,8546112.0,PCS,Issue to Patient,2.0,2.34026,-4.68052,350.0,819.09168
6590020029,MAGNESIUM SULPHATE 50% INJ -5ML,Medicine,Rayan Hospital,RYN_IP,,,,1186397582,27-05-2024,4.2,-16.8,8546112.0,PCS,Issue to Patient,4.0,2.34026,-9.36105,346.0,809.73063
6590020029,MAGNESIUM SULPHATE 50% INJ -5ML,Medicine,Rayan Hospital,RYN_IP,,,,1186528472,27-05-2024,4.2,-4.2,8546112.0,PCS,Issue to Patient,1.0,2.34026,-2.34026,345.0,807.39037
6590020029,MAGNESIUM SULPHATE 50% INJ -5ML,Medicine,Rayan Hospital,RYN_IP,,,,1186590810,27-05-2024,4.2,-4.2,8546112.0,PCS,Issue to Patient,1.0,2.34026,-2.34026,344.0,805.05011
6590020029,MAGNESIUM SULPHATE 50% INJ -5ML,Medicine,Rayan Hospital,RYN_IP,,,,1186593878,27-05-2024,4.2,-8.4,8546112.0,PCS,Issue to Patient,2.0,2.34026,-4.68052,342.0,800.36958
6590020029,MAGNESIUM SULPHATE 50% INJ -5ML,Medicine,Rayan Hospital,RYN_IP,,,,1186599733,27-05-2024,4.2,-4.2,8546112.0,PCS,Issue to Patient,1.0,2.34026,-2.34026,341.0,798.02932
6590020029,MAGNESIUM SULPHATE 50% INJ -5ML,Medicine,Rayan Hospital,RYN_IP,,,,1186725206,27-05-2024,4.2,-8.4,8546112.0,PCS,Issue to Patient,2.0,2.34026,-4.68052,339.0,793.3488
6590020029,MAGNESIUM SULPHATE 50% INJ -5ML,Medicine,Rayan Hospital,RYN_IP,,,,1186752043,27-05-2024,4.2,-4.2,8546112.0,PCS,Issue to Patient,1.0,2.34026,-2.34026,338.0,791.00854
6590020029,MAGNESIUM SULPHATE 50% INJ -5ML,Medicine,Rayan Hospital,RYN_IP,,,,1186757122,27-05-2024,2.1,-2.1,8546103.0,PCS,Issue to Patient,1.0,2.34026,-2.34026,337.0,788.66828
6590020029,MAGNESIUM SULPHATE 50% INJ -5ML,Medicine,Rayan Hospital,STAGE,Rayan Hospital Clinics,RAY_ER,17628369,1186826233,27-05-2024,2.1,-6.3,8546106.0,PCS,Int Order Direct Ship,3.0,2.34026,-7.02079,334.0,781.64749
6590020029,MAGNESIUM SULPHATE 50% INJ -5ML,Medicine,Rayan Hospital,RYN_IP,,,,1186840911,27-05-2024,2.1,-2.1,8546106.0,PCS,Issue to Patient,1.0,2.34026,-2.34026,333.0,779.30723
6590020029,MAGNESIUM SULPHATE 50% INJ -5ML,Medicine,Rayan Hospital,RYN_IP,,,,1186861237,27-05-2024,2.1,-8.4,8546106.0,PCS,Issue to Patient,4.0,2.34026,-9.36105,329.0,769.94618
6590020029,MAGNESIUM SULPHATE 50% INJ -5ML,Medicine,Rayan Hospital,RYN_IP,,,,1187065201,28-05-2024,4.2,-4.2,8546112.0,PCS,Issue to Patient,1.0,2.34026,-2.34026,328.0,767.60592
6590020029,MAGNESIUM SULPHATE 50% INJ -5ML,Medicine,Rayan Hospital,RYN_IP,,,,1187224376,28-05-2024,4.2,-8.4,8546112.0,PCS,Issue to Patient,2.0,2.34026,-4.68052,326.0,762.92539
6590020029,MAGNESIUM SULPHATE 50% INJ -5ML,Medicine,Rayan Hospital,RYN_IP,,,,1187232462,28-05-2024,4.2,-8.4,8546112.0,PCS,Issue to Patient,2.0,2.34026,-4.68052,324.0,758.24487
6590020029,MAGNESIUM SULPHATE 50% INJ -5ML,Medicine,Rayan Hospital,RYN_IP,,,,1187302972,28-05-2024,2.1,-2.1,8546103.0,PCS,Issue to Patient,1.0,2.34026,-2.34026,323.0,755.90461
6590020029,MAGNESIUM SULPHATE 50% INJ -5ML,Medicine,Rayan Hospital,RYN_IP,,,,1187361828,28-05-2024,4.2,-8.4,8546112.0,PCS,Issue to Patient,2.0,2.34026,-4.68052,321.0,751.22408
6590020029,MAGNESIUM SULPHATE 50% INJ -5ML,Medicine,Rayan Hospital,RYN_IP,,,,1187406464,28-05-2024,2.1,-2.1,8546103.0,PCS,Issue to Patient,1.0,2.34026,-2.34026,320.0,748.88382
6590020029,MAGNESIUM SULPHATE 50% INJ -5ML,Medicine,Rayan Hospital,RYN_IP,,,,1187417410,28-05-2024,4.2,-4.2,8546112.0,PCS,Issue to Patient,1.0,2.34026,-2.34026,319.0,746.54356
6590020029,MAGNESIUM SULPHATE 50% INJ -5ML,Medicine,Rayan Hospital,RYN_IP,,,,1187526275,28-05-2024,2.1,-4.2,8546106.0,PCS,Issue to Patient,2.0,2.34026,-4.68052,317.0,741.86304
6590020029,MAGNESIUM SULPHATE 50% INJ -5ML,Medicine,Rayan Hospital,RYN_IP,,,,1187654612,28-05-2024,2.1,-4.2,8546106.0,PCS,Issue to Patient,2.0,2.34026,-4.68052,315.0,737.18251
6590020029,MAGNESIUM SULPHATE 50% INJ -5ML,Medicine,Rayan Hospital,RYN_IP,,,,1187729059,29-05-2024,2.1,-2.1,8546106.0,PCS,Issue to Patient,1.0,2.34026,-2.34026,314.0,734.84225
6590020029,MAGNESIUM SULPHATE 50% INJ -5ML,Medicine,Rayan Hospital,RYN_IP,,,,1187798643,29-05-2024,2.1,-2.1,8546106.0,PCS,Issue to Patient,1.0,2.34026,-2.34026,313.0,732.50199
6590020029,MAGNESIUM SULPHATE 50% INJ -5ML,Medicine,Rayan Hospital,RYN_IP,,,,1187798658,29-05-2024,4.2,-8.4,8546112.0,PCS,Issue to Patient,2.0,2.34026,-4.68052,311.0,727.82146
6590020029,MAGNESIUM SULPHATE 50% INJ -5ML,Medicine,Rayan Hospital,RYN_IP,,,,1187812136,29-05-2024,4.2,-8.4,8546112.0,PCS,Issue to Patient,2.0,2.34026,-4.68052,309.0,723.14094
6590020029,MAGNESIUM SULPHATE 50% INJ -5ML,Medicine,Rayan Hospital,RYN_IP,,,,1187825786,29-05-2024,4.2,-4.2,8546112.0,PCS,Issue to Patient,1.0,2.34026,-2.34026,308.0,720.80068
6590020029,MAGNESIUM SULPHATE 50% INJ -5ML,Medicine,Rayan Hospital,RYN_IP,,,,1187991923,29-05-2024,2.1,-2.1,8546106.0,PCS,Issue to Patient,1.0,2.34026,-2.34026,307.0,718.46042
6590020029,MAGNESIUM SULPHATE 50% INJ -5ML,Medicine,Rayan Hospital,RYN_IP,,,,1188000254,29-05-2024,2.1,-2.1,8546103.0,PCS,Issue to Patient,1.0,2.34026,-2.34026,306.0,716.12015
6590020029,MAGNESIUM SULPHATE 50% INJ -5ML,Medicine,Rayan Hospital,RYN_IP,,,,1188005015,29-05-2024,4.2,-4.2,8546112.0,PCS,Issue to Patient,1.0,2.34026,-2.34026,305.0,713.77989
6590020029,MAGNESIUM SULPHATE 50% INJ -5ML,Medicine,Rayan Hospital,RYN_IP,,,,1188058614,29-05-2024,2.1,-2.1,8546106.0,PCS,Issue to Patient,1.0,2.34026,-2.34026,304.0,711.43963
6590020029,MAGNESIUM SULPHATE 50% INJ -5ML,Medicine,Rayan Hospital,RYN_IP,,,,1188069686,29-05-2024,4.2,-4.2,8546112.0,PCS,Issue to Patient,1.0,2.34026,-2.34026,303.0,709.09937
6590020029,MAGNESIUM SULPHATE 50% INJ -5ML,Medicine,Rayan Hospital,RYN_IP,,,,1188334219,30-05-2024,2.1,-2.1,8546106.0,PCS,Issue to Patient,1.0,2.34026,-2.34026,302.0,706.75911
6590020029,MAGNESIUM SULPHATE 50% INJ -5ML,Medicine,Rayan Hospital,RYN_IP,,,,1188371208,30-05-2024,2.1,-4.2,8546106.0,PCS,Issue to Patient,2.0,2.34026,-4.68052,300.0,702.07858
6590020029,MAGNESIUM SULPHATE 50% INJ -5ML,Medicine,Rayan Hospital,STAGE,Rayan Hospital Clinics,RAY_ER,17634014,1188381908,30-05-2024,2.1,-4.2,8546106.0,PCS,Int Order Direct Ship,2.0,2.34026,-4.68052,298.0,697.39806
6590020029,MAGNESIUM SULPHATE 50% INJ -5ML,Medicine,Rayan Hospital,RYN_IP,,,,1188572425,30-05-2024,4.2,-16.8,8546112.0,PCS,Issue to Patient,4.0,2.34026,-9.36105,294.0,688.03701
6590020029,MAGNESIUM SULPHATE 50% INJ -5ML,Medicine,Rayan Hospital,RAY_OBGY1F,,,,1188674328,30-05-2024,2.1,-12.6,8546100.0,PCS,Physical Inv Adjust,6.0,2.34026,-14.04157,288.0,673.99544
6590020029,MAGNESIUM SULPHATE 50% INJ -5ML,Medicine,Rayan Hospital,RYN_IP,,,,1188708465,30-05-2024,2.1,-2.1,8546103.0,PCS,Issue to Patient,1.0,2.34026,-2.34026,293.0,685.69675
6590020029,MAGNESIUM SULPHATE 50% INJ -5ML,Medicine,Rayan Hospital,RYN_IP,,,,1188718470,30-05-2024,2.1,-2.1,8546111.0,PCS,Issue to Patient,1.0,2.34026,-2.34026,292.0,683.35649
6590020029,MAGNESIUM SULPHATE 50% INJ -5ML,Medicine,Rayan Hospital,RYN_IP,,,,1188739625,30-05-2024,4.2,-4.2,8546112.0,PCS,Issue to Patient,1.0,2.34026,-2.34026,291.0,681.01623
6590020029,MAGNESIUM SULPHATE 50% INJ -5ML,Medicine,Rayan Hospital,RYN_IP,,,,1188743012,30-05-2024,4.2,-4.2,8546112.0,PCS,Issue to Patient,1.0,2.34026,-2.34026,290.0,678.67596
6590020029,MAGNESIUM SULPHATE 50% INJ -5ML,Medicine,Rayan Hospital,RYN_IP,,,,1188751990,30-05-2024,2.1,-6.3,8546106.0,PCS,Issue to Patient,3.0,2.34026,-7.02079,287.0,671.65518
6590020029,MAGNESIUM SULPHATE 50% INJ -5ML,Medicine,Rayan Hospital,RYN_IP,,,,1188907156,30-05-2024,2.1,-4.2,8546106.0,PCS,Issue to Patient,2.0,2.34026,-4.68052,285.0,666.97465
6590020029,MAGNESIUM SULPHATE 50% INJ -5ML,Medicine,Rayan Hospital,RYN_IP,,,,1188940844,31-05-2024,4.2,-8.4,8546112.0,PCS,Issue to Patient,2.0,2.34026,-4.68052,283.0,662.29413
6590020029,MAGNESIUM SULPHATE 50% INJ -5ML,Medicine,Rayan Hospital,RYN_IP,,,,1189021839,31-05-2024,2.1,-2.1,8546106.0,PCS,Issue to Patient,1.0,2.34026,-2.34026,282.0,659.95387
6590020029,MAGNESIUM SULPHATE 50% INJ -5ML,Medicine,Rayan Hospital,RYN_IP,,,,1189040188,31-05-2024,2.1,-2.1,8546103.0,PCS,Issue to Patient,1.0,2.34026,-2.34026,281.0,657.61361
6590020029,MAGNESIUM SULPHATE 50% INJ -5ML,Medicine,Rayan Hospital,RYN_IP,,,,1189041658,31-05-2024,2.1,-2.1,8546106.0,PCS,Issue to Patient,1.0,2.34026,-2.34026,280.0,655.27334
6590020029,MAGNESIUM SULPHATE 50% INJ -5ML,Medicine,Rayan Hospital,RAY_RDLOGY,,,,1189069754,31-05-2024,2.1,-8.4,8546100.0,PCS,Physical Inv Adjust,4.0,2.34026,-9.36105,276.0,645.9123
6590020029,MAGNESIUM SULPHATE 50% INJ -5ML,Medicine,Rayan Hospital,RYN_IP,,,,1189072764,31-05-2024,2.1,-2.1,8546103.0,PCS,Issue to Patient,1.0,2.34026,-2.34026,279.0,652.93308
6590020029,MAGNESIUM SULPHATE 50% INJ -5ML,Medicine,Rayan Hospital,RYN_IP,,,,1189074266,31-05-2024,2.1,-2.1,8546103.0,PCS,Issue to Patient,1.0,2.34026,-2.34026,278.0,650.59282
6590020029,MAGNESIUM SULPHATE 50% INJ -5ML,Medicine,Rayan Hospital,RYN_IP,,,,1189092948,31-05-2024,4.2,-4.2,8546112.0,PCS,Issue to Patient,1.0,2.34026,-2.34026,277.0,648.25256
6590020029,MAGNESIUM SULPHATE 50% INJ -5ML,Medicine,Rayan Hospital,RYN_IP,,,,1189101192,31-05-2024,4.2,-8.4,8546112.0,PCS,Issue to Patient,2.0,2.34026,-4.68052,275.0,643.57203
6590020029,MAGNESIUM SULPHATE 50% INJ -5ML,Medicine,Rayan Hospital,RYN_IP,,,,1189138568,31-05-2024,2.1,-2.1,8546106.0,PCS,Issue to Patient,1.0,2.34026,-2.34026,274.0,641.23177
6590020029,MAGNESIUM SULPHATE 50% INJ -5ML,Medicine,Rayan Hospital,RYN_IP,,,,1189196257,01-06-2024,4.2,-8.4,8546112.0,PCS,Issue to Patient,2.0,2.34026,-4.68052,272.0,636.55125
6590020029,MAGNESIUM SULPHATE 50% INJ -5ML,Medicine,Rayan Hospital,RYN_IP,,,,1189203144,01-06-2024,2.1,-4.2,8546106.0,PCS,Issue to Patient,2.0,2.34026,-4.68052,270.0,631.87072
6590020029,MAGNESIUM SULPHATE 50% INJ -5ML,Medicine,Rayan Hospital,RYN_IP,,,,1189239246,01-06-2024,2.1,-4.2,8546106.0,PCS,Issue to Patient,2.0,2.34026,-4.68052,268.0,627.1902
6590020029,MAGNESIUM SULPHATE 50% INJ -5ML,Medicine,Rayan Hospital,RYN_IP,,,,1189240316,01-06-2024,4.2,-8.4,8546112.0,PCS,Issue to Patient,2.0,2.34026,-4.68052,266.0,622.50968
6590020029,MAGNESIUM SULPHATE 50% INJ -5ML,Medicine,Rayan Hospital,RYN_IP,,,,1189241036,01-06-2024,2.1,-4.2,8546106.0,PCS,Issue to Patient,2.0,2.34026,-4.68052,264.0,617.82915
6590020029,MAGNESIUM SULPHATE 50% INJ -5ML,Medicine,Rayan Hospital,RYN_IP,,,,1189253005,01-06-2024,4.2,-4.2,8546112.0,PCS,Issue to Patient,1.0,2.34026,-2.34026,263.0,615.48889
6590020029,MAGNESIUM SULPHATE 50% INJ -5ML,Medicine,Rayan Hospital,RYN_IP,,,,1189322492,01-06-2024,4.2,-4.2,8546112.0,PCS,Issue to Patient,1.0,2.34026,-2.34026,262.0,613.14863
6590020029,MAGNESIUM SULPHATE 50% INJ -5ML,Medicine,Rayan Hospital,RYN_IP,,,,1189408172,01-06-2024,2.1,-2.1,8546103.0,PCS,Issue to Patient,1.0,2.34026,-2.34026,261.0,610.80837
6590020029,MAGNESIUM SULPHATE 50% INJ -5ML,Medicine,Rayan Hospital,RYN_IP,,,,1189441065,01-06-2024,2.1,-2.1,8546103.0,PCS,Issue to Patient,1.0,2.34026,-2.34026,260.0,608.46811
6590020029,MAGNESIUM SULPHATE 50% INJ -5ML,Medicine,Rayan Hospital,RYN_IP,,,,1189445845,01-06-2024,2.1,-2.1,8546103.0,PCS,Issue to Patient,1.0,2.34026,-2.34026,259.0,606.12784
6590020029,MAGNESIUM SULPHATE 50% INJ -5ML,Medicine,Rayan Hospital,RYN_IP,,,,1189502139,01-06-2024,4.2,-4.2,8546112.0,PCS,Issue to Patient,1.0,2.34026,-2.34026,258.0,603.78758
6590020029,MAGNESIUM SULPHATE 50% INJ -5ML,Medicine,Rayan Hospital,RYN_IP,,,,1189565596,01-06-2024,2.1,-2.1,8546103.0,PCS,Issue to Patient,1.0,2.34026,-2.34026,257.0,601.44732
6590020029,MAGNESIUM SULPHATE 50% INJ -5ML,Medicine,Rayan Hospital,RYN_IP,,,,1189803053,01-06-2024,4.2,-8.4,8546113.0,PCS,Issue to Patient,2.0,2.74356,-5.48712,655.0,1797.0321
6590020029,MAGNESIUM SULPHATE 50% INJ -5ML,Medicine,Rayan Hospital,RYN_IP,,,,1189849126,02-06-2024,4.2,-8.4,8546113.0,PCS,Issue to Patient,2.0,2.74356,-5.48712,653.0,1791.54498
6590020029,MAGNESIUM SULPHATE 50% INJ -5ML,Medicine,Rayan Hospital,RYN_IP,,,,1189849141,02-06-2024,4.2,-16.8,8546113.0,PCS,Issue to Patient,4.0,2.74356,-10.97424,649.0,1780.57073
6590020029,MAGNESIUM SULPHATE 50% INJ -5ML,Medicine,Rayan Hospital,RYN_IP,,,,1189871392,02-06-2024,4.2,-4.2,8546113.0,PCS,Issue to Patient,1.0,2.74356,-2.74356,648.0,1777.82717
6590020029,MAGNESIUM SULPHATE 50% INJ -5ML,Medicine,Rayan Hospital,RYN_IP,,,,1189901887,02-06-2024,4.2,-16.8,8546113.0,PCS,Issue to Patient,4.0,2.74356,-10.97424,644.0,1766.85293
6590020029,MAGNESIUM SULPHATE 50% INJ -5ML,Medicine,Rayan Hospital,STAGE,Rayan Hospital Clinics,RAY_ER,17641568,1189917417,02-06-2024,2.1,-8.4,8546106.0,PCS,Int Order Direct Ship,4.0,2.74356,-10.97424,640.0,1755.87869
6590020029,MAGNESIUM SULPHATE 50% INJ -5ML,Medicine,Rayan Hospital,RYN_IP,,,,1189935636,02-06-2024,4.2,-4.2,8546113.0,PCS,Issue to Patient,1.0,2.74356,-2.74356,639.0,1753.13513
6590020029,MAGNESIUM SULPHATE 50% INJ -5ML,Medicine,Rayan Hospital,RYN_IP,,,,1189950666,02-06-2024,4.2,-4.2,8546113.0,PCS,Issue to Patient,1.0,2.74356,-2.74356,638.0,1750.39157
6590020029,MAGNESIUM SULPHATE 50% INJ -5ML,Medicine,Rayan Hospital,RYN_IP,,,,1189967424,02-06-2024,4.2,-4.2,8546113.0,PCS,Issue to Patient,1.0,2.74356,-2.74356,637.0,1747.64801
6590020029,MAGNESIUM SULPHATE 50% INJ -5ML,Medicine,Rayan Hospital,RYN_IP,,,,1190033516,02-06-2024,4.2,-16.8,8546113.0,PCS,Issue to Patient,4.0,2.74356,-10.97424,633.0,1736.67377
6590020029,MAGNESIUM SULPHATE 50% INJ -5ML,Medicine,Rayan Hospital,RYN_IP,,,,1190094946,02-06-2024,4.2,-8.4,8546113.0,PCS,Issue to Patient,2.0,2.74356,-5.48712,635.0,1742.16089
6590020029,MAGNESIUM SULPHATE 50% INJ -5ML,Medicine,Rayan Hospital,RYN_IP,,,,1190166233,02-06-2024,4.2,-4.2,8546113.0,PCS,Issue to Patient,1.0,2.74356,-2.74356,634.0,1739.41733
6590020029,MAGNESIUM SULPHATE 50% INJ -5ML,Medicine,Rayan Hospital,RYN_IP,,,,1190204078,02-06-2024,4.2,-4.2,8546113.0,PCS,Issue to Patient,1.0,2.74356,-2.74356,633.0,1736.67377
6590020029,MAGNESIUM SULPHATE 50% INJ -5ML,Medicine,Rayan Hospital,RYN_IP,,,,1190211302,02-06-2024,4.2,-16.8,8546113.0,PCS,Issue to Patient,4.0,2.74356,-10.97424,629.0,1725.69953
6590020029,MAGNESIUM SULPHATE 50% INJ -5ML,Medicine,Rayan Hospital,RYN_IP,,,,1190466683,02-06-2024,4.2,-8.4,8546113.0,PCS,Issue to Patient,2.0,2.74356,-5.48712,627.0,1720.2124
6590020029,MAGNESIUM SULPHATE 50% INJ -5ML,Medicine,Rayan Hospital,RYN_IP,,,,1190541308,03-06-2024,4.2,-8.4,8546113.0,PCS,Issue to Patient,2.0,2.74356,-5.48712,625.0,1714.72528
6590020029,MAGNESIUM SULPHATE 50% INJ -5ML,Medicine,Rayan Hospital,RYN_IP,,,,1190578863,03-06-2024,4.2,-8.4,8546113.0,PCS,Issue to Patient,2.0,2.74356,-5.48712,623.0,1709.23816
6590020029,MAGNESIUM SULPHATE 50% INJ -5ML,Medicine,Rayan Hospital,RYN_IP,,,,1190583550,03-06-2024,4.2,-8.4,8546113.0,PCS,Issue to Patient,2.0,2.74356,-5.48712,621.0,1703.75104
6590020029,MAGNESIUM SULPHATE 50% INJ -5ML,Medicine,Rayan Hospital,RYN_IP,,,,1190835644,03-06-2024,4.2,-8.4,8546113.0,PCS,Issue to Patient,2.0,2.74356,-5.48712,619.0,1698.26392
6590020029,MAGNESIUM SULPHATE 50% INJ -5ML,Medicine,Rayan Hospital,RYN_IP,,,,1190841497,03-06-2024,2.1,-4.2,8546103.0,PCS,Issue to Patient,2.0,2.74356,-5.48712,617.0,1692.7768
6590020029,MAGNESIUM SULPHATE 50% INJ -5ML,Medicine,Rayan Hospital,RYN_IP,,,,1190927275,03-06-2024,4.2,-4.2,8546113.0,PCS,Issue to Patient,1.0,2.74356,-2.74356,616.0,1690.03324
6590020029,MAGNESIUM SULPHATE 50% INJ -5ML,Medicine,Rayan Hospital,RYN_IP,,,,1191101318,03-06-2024,4.2,-8.4,8546113.0,PCS,Issue to Patient,2.0,2.74356,-5.48712,614.0,1684.54612
6590020029,MAGNESIUM SULPHATE 50% INJ -5ML,Medicine,Rayan Hospital,RYN_IP,,,,1191132065,03-06-2024,4.2,-8.4,8546113.0,PCS,Issue to Patient,2.0,2.74356,-5.48712,612.0,1679.059
6590020029,MAGNESIUM SULPHATE 50% INJ -5ML,Medicine,Rayan Hospital,RYN_IP,,,,1191261918,04-06-2024,4.2,-4.2,8546113.0,PCS,Issue to Patient,1.0,2.74356,-2.74356,611.0,1676.31544
6590020029,MAGNESIUM SULPHATE 50% INJ -5ML,Medicine,Rayan Hospital,RYN_IP,,,,1191283234,04-06-2024,4.2,-8.4,8546113.0,PCS,Issue to Patient,2.0,2.74356,-5.48712,609.0,1670.82832
6590020029,MAGNESIUM SULPHATE 50% INJ -5ML,Medicine,Rayan Hospital,RYN_IP,,,,1191335555,04-06-2024,4.2,-4.2,8546112.0,PCS,Issue to Patient,1.0,2.74356,-2.74356,608.0,1668.08476
6590020029,MAGNESIUM SULPHATE 50% INJ -5ML,Medicine,Rayan Hospital,RYN_IP,,,,1191409052,04-06-2024,4.2,-4.2,8546113.0,PCS,Issue to Patient,1.0,2.74356,-2.74356,607.0,1665.3412
6590020029,MAGNESIUM SULPHATE 50% INJ -5ML,Medicine,Rayan Hospital,STAGE,Rayan Hospital Clinics,RAY_SURWRD,17644852,1191511471,04-06-2024,2.1,-4.2,8546106.0,PCS,Int Order Direct Ship,2.0,2.74356,-5.48712,605.0,1659.85407
6590020029,MAGNESIUM SULPHATE 50% INJ -5ML,Medicine,Rayan Hospital,RYN_IP,,,,1191819450,05-06-2024,4.2,-8.4,8546113.0,PCS,Issue to Patient,2.0,2.74356,-5.48712,603.0,1654.36695
6590020029,MAGNESIUM SULPHATE 50% INJ -5ML,Medicine,Rayan Hospital,RYN_IP,,,,1191827412,05-06-2024,4.2,-4.2,8546113.0,PCS,Issue to Patient,1.0,2.74356,-2.74356,602.0,1651.62339
6590020029,MAGNESIUM SULPHATE 50% INJ -5ML,Medicine,Rayan Hospital,STAGE,Rayan Hospital Clinics,RAY_ER,17644456,1191882395,05-06-2024,2.1,-6.3,8546106.0,PCS,Int Order Direct Ship,3.0,2.74356,-8.23068,599.0,1643.39271
6590020029,MAGNESIUM SULPHATE 50% INJ -5ML,Medicine,Rayan Hospital,RYN_IP,,,,1191884823,05-06-2024,4.2,-8.4,8546113.0,PCS,Issue to Patient,2.0,2.74356,-5.48712,597.0,1637.90559
6590020029,MAGNESIUM SULPHATE 50% INJ -5ML,Medicine,Rayan Hospital,RYN_IP,,,,1191886404,05-06-2024,4.2,-8.4,8546113.0,PCS,Issue to Patient,2.0,2.74356,-5.48712,595.0,1632.41847
6590020029,MAGNESIUM SULPHATE 50% INJ -5ML,Medicine,Rayan Hospital,RYN_IP,,,,1191886414,05-06-2024,4.2,-8.4,8546113.0,PCS,Issue to Patient,2.0,2.74356,-5.48712,593.0,1626.93135
6590020029,MAGNESIUM SULPHATE 50% INJ -5ML,Medicine,Rayan Hospital,RYN_IP,,,,1191887860,05-06-2024,4.2,-8.4,8546113.0,PCS,Issue to Patient,2.0,2.74356,-5.48712,591.0,1621.44423
6590020029,MAGNESIUM SULPHATE 50% INJ -5ML,Medicine,Rayan Hospital,RYN_IP,,,,1191887880,05-06-2024,4.2,-8.4,8546113.0,PCS,Issue to Patient,2.0,2.74356,-5.48712,589.0,1615.95711
6590020029,MAGNESIUM SULPHATE 50% INJ -5ML,Medicine,Rayan Hospital,RYN_IP,,,,1191890349,05-06-2024,4.2,-8.4,8546113.0,PCS,Issue to Patient,2.0,2.74356,-5.48712,587.0,1610.46999
6590020029,MAGNESIUM SULPHATE 50% INJ -5ML,Medicine,Rayan Hospital,RYN_IP,,,,1192129420,05-06-2024,4.2,-4.2,8546113.0,PCS,Issue to Patient,1.0,2.74356,-2.74356,586.0,1607.72643
6590020029,MAGNESIUM SULPHATE 50% INJ -5ML,Medicine,Rayan Hospital,RYN_IP,,,,1192204792,05-06-2024,2.1,-2.1,8546103.0,PCS,Issue to Patient,1.0,2.74356,-2.74356,585.0,1604.98287
6590020029,MAGNESIUM SULPHATE 50% INJ -5ML,Medicine,Rayan Hospital,RYN_IP,,,,1192207045,05-06-2024,2.1,-2.1,8546103.0,PCS,Issue to Patient,1.0,2.74356,-2.74356,584.0,1602.23931
6590020029,MAGNESIUM SULPHATE 50% INJ -5ML,Medicine,Rayan Hospital,RYN_IP,,,,1192210050,05-06-2024,2.1,-2.1,8546106.0,PCS,Issue to Patient,1.0,2.74356,-2.74356,583.0,1599.49574
6590020029,MAGNESIUM SULPHATE 50% INJ -5ML,Medicine,Rayan Hospital,RYN_IP,,,,1192210537,05-06-2024,2.1,-2.1,8546106.0,PCS,Issue to Patient,1.0,2.74356,-2.74356,582.0,1596.75218
6590020029,MAGNESIUM SULPHATE 50% INJ -5ML,Medicine,Rayan Hospital,RYN_IP,,,,1192212988,05-06-2024,2.1,-2.1,8546104.0,PCS,Issue to Patient,1.0,2.74356,-2.74356,581.0,1594.00862
6590020029,MAGNESIUM SULPHATE 50% INJ -5ML,Medicine,Rayan Hospital,RYN_IP,,,,1192283167,05-06-2024,4.2,-4.2,8546113.0,PCS,Issue to Patient,1.0,2.74356,-2.74356,580.0,1591.26506
6590020029,MAGNESIUM SULPHATE 50% INJ -5ML,Medicine,Rayan Hospital,RYN_IP,,,,1192292312,05-06-2024,4.2,-4.2,8546113.0,PCS,Issue to Patient,1.0,2.74356,-2.74356,579.0,1588.5215
6590020029,MAGNESIUM SULPHATE 50% INJ -5ML,Medicine,Rayan Hospital,RYN_IP,,,,1192454226,05-06-2024,4.2,-4.2,8546113.0,PCS,Issue to Patient,1.0,2.74356,-2.74356,578.0,1585.77794
6590020029,MAGNESIUM SULPHATE 50% INJ -5ML,Medicine,Rayan Hospital,RYN_IP,,,,1192493994,06-06-2024,4.2,-8.4,8546113.0,PCS,Issue to Patient,2.0,2.74356,-5.48712,576.0,1580.29082
6590020029,MAGNESIUM SULPHATE 50% INJ -5ML,Medicine,Rayan Hospital,RYN_IP,,,,1192525648,06-06-2024,4.2,-8.4,8546113.0,PCS,Issue to Patient,2.0,2.74356,-5.48712,574.0,1574.8037
6590020029,MAGNESIUM SULPHATE 50% INJ -5ML,Medicine,Rayan Hospital,RYN_IP,,,,1192526009,06-06-2024,4.2,-8.4,8546113.0,PCS,Issue to Patient,2.0,2.74356,-5.48712,572.0,1569.31658
6590020029,MAGNESIUM SULPHATE 50% INJ -5ML,Medicine,Rayan Hospital,RYN_IP,,,,1192528449,06-06-2024,4.2,-8.4,8546113.0,PCS,Issue to Patient,2.0,2.74356,-5.48712,570.0,1563.82946
6590020029,MAGNESIUM SULPHATE 50% INJ -5ML,Medicine,Rayan Hospital,RYN_IP,,,,1192765521,06-06-2024,4.2,-4.2,8546112.0,PCS,Issue to Patient,1.0,2.74356,-2.74356,569.0,1561.0859
6590020029,MAGNESIUM SULPHATE 50% INJ -5ML,Medicine,Rayan Hospital,RYN_IP,,,,1192867798,06-06-2024,2.1,-4.2,8546106.0,PCS,Issue to Patient,2.0,2.74356,-5.48712,567.0,1555.59878
6590020029,MAGNESIUM SULPHATE 50% INJ -5ML,Medicine,Rayan Hospital,RYN_IP,,,,1192869723,06-06-2024,2.1,-2.1,8546104.0,PCS,Issue to Patient,1.0,2.74356,-2.74356,566.0,1552.85522
6590020029,MAGNESIUM SULPHATE 50% INJ -5ML,Medicine,Rayan Hospital,RYN_IP,,,,1192869748,06-06-2024,2.1,-2.1,8546106.0,PCS,Issue to Patient,1.0,2.74356,-2.74356,565.0,1550.11166
6590020029,MAGNESIUM SULPHATE 50% INJ -5ML,Medicine,Rayan Hospital,RYN_IP,,,,1192954508,06-06-2024,4.2,-4.2,8546112.0,PCS,Issue to Patient,1.0,2.74356,-2.74356,564.0,1547.3681
6590020029,MAGNESIUM SULPHATE 50% INJ -5ML,Medicine,Rayan Hospital,RYN_IP,,,,1193093536,07-06-2024,4.2,-4.2,8546113.0,PCS,Issue to Patient,1.0,2.74356,-2.74356,563.0,1544.62454
6590020029,MAGNESIUM SULPHATE 50% INJ -5ML,Medicine,Rayan Hospital,RYN_IP,,,,1193131231,07-06-2024,4.2,-4.2,8546113.0,PCS,Issue to Patient,1.0,2.74356,-2.74356,562.0,1541.88098
6590020029,MAGNESIUM SULPHATE 50% INJ -5ML,Medicine,Rayan Hospital,RYN_IP,,,,1193154107,07-06-2024,4.2,-8.4,8546113.0,PCS,Issue to Patient,2.0,2.74356,-5.48712,560.0,1536.39385
6590020029,MAGNESIUM SULPHATE 50% INJ -5ML,Medicine,Rayan Hospital,RYN_IP,,,,1193160076,07-06-2024,4.2,-4.2,8546113.0,PCS,Issue to Patient,1.0,2.74356,-2.74356,559.0,1533.65029
6590020029,MAGNESIUM SULPHATE 50% INJ -5ML,Medicine,Rayan Hospital,RYN_IP,,,,1193175688,07-06-2024,4.2,-4.2,8546113.0,PCS,Issue to Patient,1.0,2.74356,-2.74356,558.0,1530.90673
6590020029,MAGNESIUM SULPHATE 50% INJ -5ML,Medicine,Rayan Hospital,RYN_IP,,,,1193178485,07-06-2024,4.2,-8.4,8546113.0,PCS,Issue to Patient,2.0,2.74356,-5.48712,556.0,1525.41961
6590020029,MAGNESIUM SULPHATE 50% INJ -5ML,Medicine,Rayan Hospital,RYN_IP,,,,1193185673,07-06-2024,4.2,-8.4,8546113.0,PCS,Issue to Patient,2.0,2.74356,-5.48712,554.0,1519.93249
6590020029,MAGNESIUM SULPHATE 50% INJ -5ML,Medicine,Rayan Hospital,RYN_IP,,,,1193187749,07-06-2024,2.1,-4.2,8546103.0,PCS,Issue to Patient,2.0,2.74356,-5.48712,552.0,1514.44537
6590020029,MAGNESIUM SULPHATE 50% INJ -5ML,Medicine,Rayan Hospital,RYN_IP,,,,1193190591,07-06-2024,2.1,-2.1,8546104.0,PCS,Issue to Patient,1.0,2.74356,-2.74356,551.0,1511.70181
6590020029,MAGNESIUM SULPHATE 50% INJ -5ML,Medicine,Rayan Hospital,RYN_IP,,,,1193191399,07-06-2024,4.2,-8.4,8546112.0,PCS,Issue to Patient,2.0,2.74356,-5.48712,549.0,1506.21469
6590020029,MAGNESIUM SULPHATE 50% INJ -5ML,Medicine,Rayan Hospital,RYN_IP,,,,1193216569,07-06-2024,2.1,-4.2,8546106.0,PCS,Issue to Patient,2.0,2.74356,-5.48712,547.0,1500.72757
6590020029,MAGNESIUM SULPHATE 50% INJ -5ML,Medicine,Rayan Hospital,RYN_IP,,,,1193216594,07-06-2024,2.1,-4.2,8546104.0,PCS,Issue to Patient,2.0,2.74356,-5.48712,545.0,1495.24045
6590020029,MAGNESIUM SULPHATE 50% INJ -5ML,Medicine,Rayan Hospital,RYN_IP,,,,1193315096,07-06-2024,4.2,-4.2,8546113.0,PCS,Issue to Patient,1.0,2.74356,-2.74356,544.0,1492.49689
6590020029,MAGNESIUM SULPHATE 50% INJ -5ML,Medicine,Rayan Hospital,RYN_IP,,,,1193315146,07-06-2024,4.2,-4.2,8546113.0,PCS,Issue to Patient,1.0,2.74356,-2.74356,543.0,1489.75333
6590020029,MAGNESIUM SULPHATE 50% INJ -5ML,Medicine,Rayan Hospital,RYN_IP,,,,1193318451,07-06-2024,4.2,-4.2,8546113.0,PCS,Issue to Patient,1.0,2.74356,-2.74356,542.0,1487.00977
6590020029,MAGNESIUM SULPHATE 50% INJ -5ML,Medicine,Rayan Hospital,RYN_IP,,,,1193318471,07-06-2024,4.2,-4.2,8546113.0,PCS,Issue to Patient,1.0,2.74356,-2.74356,542.0,1487.00977
6590020029,MAGNESIUM SULPHATE 50% INJ -5ML,Medicine,Rayan Hospital,RYN_IP,,,,1193328239,07-06-2024,4.2,-8.4,8546113.0,PCS,Issue to Patient,2.0,2.74356,-5.48712,541.0,1484.26621
6590020029,MAGNESIUM SULPHATE 50% INJ -5ML,Medicine,Rayan Hospital,RYN_IP,,,,1193336503,07-06-2024,4.2,-8.4,8546113.0,PCS,Issue to Patient,2.0,2.74356,-5.48712,539.0,1478.77908
6590020029,MAGNESIUM SULPHATE 50% INJ -5ML,Medicine,Rayan Hospital,RYN_IP,,,,1193338742,07-06-2024,4.2,-8.4,8546113.0,PCS,Issue to Patient,2.0,2.74356,-5.48712,537.0,1473.29196
6590020029,MAGNESIUM SULPHATE 50% INJ -5ML,Medicine,Rayan Hospital,RYN_IP,,,,1193388936,08-06-2024,4.2,-4.2,8546113.0,PCS,Issue to Patient,1.0,2.74356,-2.74356,536.0,1470.5484
6590020029,MAGNESIUM SULPHATE 50% INJ -5ML,Medicine,Rayan Hospital,RYN_IP,,,,1193390119,08-06-2024,4.2,-8.4,8546113.0,PCS,Issue to Patient,2.0,2.74356,-5.48712,534.0,1465.06128
6590020029,MAGNESIUM SULPHATE 50% INJ -5ML,Medicine,Rayan Hospital,RYN_IP,,,,1193390139,08-06-2024,4.2,-8.4,8546113.0,PCS,Issue to Patient,2.0,2.74356,-5.48712,532.0,1459.57416
6590020029,MAGNESIUM SULPHATE 50% INJ -5ML,Medicine,Rayan Hospital,RYN_IP,,,,1193419183,08-06-2024,4.2,-4.2,8546113.0,PCS,Issue to Patient,1.0,2.74356,-2.74356,531.0,1456.8306
6590020029,MAGNESIUM SULPHATE 50% INJ -5ML,Medicine,Rayan Hospital,RYN_IP,,,,1193426679,08-06-2024,4.2,-4.2,8546113.0,PCS,Issue to Patient,1.0,2.74356,-2.74356,532.0,1459.57416
6590020029,MAGNESIUM SULPHATE 50% INJ -5ML,Medicine,Rayan Hospital,RYN_IP,,,,1193433753,08-06-2024,4.2,-8.4,8546113.0,PCS,Issue to Patient,2.0,2.73993,-5.47986,530.0,1452.16414
6590020029,MAGNESIUM SULPHATE 50% INJ -5ML,Medicine,Rayan Hospital,RYN_IP,,,,1193571381,08-06-2024,2.1,-2.1,8546104.0,PCS,Issue to Patient,1.0,2.73993,-2.73993,529.0,1449.4242
6590020029,MAGNESIUM SULPHATE 50% INJ -5ML,Medicine,Rayan Hospital,RYN_IP,,,,1193623669,08-06-2024,2.1,-2.1,8546103.0,PCS,Issue to Patient,1.0,2.73993,-2.73993,528.0,1446.68427
6590020029,MAGNESIUM SULPHATE 50% INJ -5ML,Medicine,Rayan Hospital,RYN_IP,,,,1193623821,08-06-2024,2.1,-2.1,8546104.0,PCS,Issue to Patient,1.0,2.73993,-2.73993,527.0,1443.94434
6590020029,MAGNESIUM SULPHATE 50% INJ -5ML,Medicine,Rayan Hospital,RYN_IP,,,,1193935655,08-06-2024,4.2,-8.4,8546113.0,PCS,Issue to Patient,2.0,2.73993,-5.47986,525.0,1438.46447
6590020029,MAGNESIUM SULPHATE 50% INJ -5ML,Medicine,Rayan Hospital,RYN_IP,,,,1193973363,08-06-2024,4.2,-8.4,8546113.0,PCS,Issue to Patient,2.0,2.73993,-5.47986,523.0,1432.98461
6590020029,MAGNESIUM SULPHATE 50% INJ -5ML,Medicine,Rayan Hospital,RYN_IP,,,,1193986893,09-06-2024,4.2,-8.4,8546113.0,PCS,Issue to Patient,2.0,2.73993,-5.47986,521.0,1427.50475
6590020029,MAGNESIUM SULPHATE 50% INJ -5ML,Medicine,Rayan Hospital,RYN_IP,,,,1193986918,09-06-2024,4.2,-8.4,8546113.0,PCS,Issue to Patient,2.0,2.73993,-5.47986,519.0,1422.02488
6590020029,MAGNESIUM SULPHATE 50% INJ -5ML,Medicine,Rayan Hospital,RYN_IP,,,,1194030177,09-06-2024,4.2,-8.4,8546113.0,PCS,Issue to Patient,2.0,2.73993,-5.47986,517.0,1416.54502
6590020029,MAGNESIUM SULPHATE 50% INJ -5ML,Medicine,Rayan Hospital,RYN_IP,,,,1194037535,09-06-2024,4.2,-8.4,8546113.0,PCS,Issue to Patient,2.0,2.73993,-5.47986,515.0,1411.06515
6590020029,MAGNESIUM SULPHATE 50% INJ -5ML,Medicine,Rayan Hospital,RYN_IP,,,,1194086955,09-06-2024,4.2,-8.4,8546113.0,PCS,Issue to Patient,2.0,2.73993,-5.47986,513.0,1405.58529
6590020029,MAGNESIUM SULPHATE 50% INJ -5ML,Medicine,Rayan Hospital,RYN_IP,,,,1194194733,09-06-2024,4.2,-4.2,8546113.0,PCS,Issue to Patient,1.0,2.73993,-2.73993,512.0,1402.84535
6590020029,MAGNESIUM SULPHATE 50% INJ -5ML,Medicine,Rayan Hospital,RYN_IP,,,,1194233018,09-06-2024,2.1,-2.1,8546103.0,PCS,Issue to Patient,1.0,2.73993,-2.73993,511.0,1400.10542
6590020029,MAGNESIUM SULPHATE 50% INJ -5ML,Medicine,Rayan Hospital,RYN_IP,,,,1194236462,09-06-2024,2.1,-2.1,8546103.0,PCS,Issue to Patient,1.0,2.73993,-2.73993,510.0,1397.36549
6590020029,MAGNESIUM SULPHATE 50% INJ -5ML,Medicine,Rayan Hospital,RYN_IP,,,,1194236777,09-06-2024,2.1,-2.1,8546103.0,PCS,Issue to Patient,1.0,2.73993,-2.73993,509.0,1394.62556
6590020029,MAGNESIUM SULPHATE 50% INJ -5ML,Medicine,Rayan Hospital,RYN_IP,,,,1194237012,09-06-2024,2.1,-2.1,8546103.0,PCS,Issue to Patient,1.0,2.73993,-2.73993,508.0,1391.88563
6590020029,MAGNESIUM SULPHATE 50% INJ -5ML,Medicine,Rayan Hospital,RYN_IP,,,,1194537662,09-06-2024,4.2,-4.2,8546113.0,PCS,Issue to Patient,1.0,2.73993,-2.73993,507.0,1389.14569
6590020029,MAGNESIUM SULPHATE 50% INJ -5ML,Medicine,Rayan Hospital,RYN_IP,,,,1194669901,10-06-2024,4.2,-8.4,8546113.0,PCS,Issue to Patient,2.0,2.73993,-5.47986,505.0,1383.66583
6590020029,MAGNESIUM SULPHATE 50% INJ -5ML,Medicine,Rayan Hospital,RYN_IP,,,,1194696471,10-06-2024,4.2,-4.2,8546113.0,PCS,Issue to Patient,1.0,2.73993,-2.73993,504.0,1380.9259
6590020029,MAGNESIUM SULPHATE 50% INJ -5ML,Medicine,Rayan Hospital,RYN_IP,,,,1194701332,10-06-2024,4.2,-8.4,8546113.0,PCS,Issue to Patient,2.0,2.73993,-5.47986,502.0,1375.44603
6590020029,MAGNESIUM SULPHATE 50% INJ -5ML,Medicine,Rayan Hospital,RYN_IP,,,,1194849139,10-06-2024,4.2,-8.4,8546113.0,PCS,Issue to Patient,2.0,2.73993,-5.47986,500.0,1369.96617
6590020029,MAGNESIUM SULPHATE 50% INJ -5ML,Medicine,Rayan Hospital,RYN_IP,,,,1194872863,10-06-2024,4.2,-16.8,8546113.0,PCS,Issue to Patient,4.0,2.73993,-10.95973,496.0,1359.00644
6590020029,MAGNESIUM SULPHATE 50% INJ -5ML,Medicine,Rayan Hospital,RYN_IP,,,,1194902217,10-06-2024,4.2,-4.2,8546112.0,PCS,Issue to Patient,1.0,2.73993,-2.73993,495.0,1356.2665
6590020029,MAGNESIUM SULPHATE 50% INJ -5ML,Medicine,Rayan Hospital,RYN_IP,,,,1194922643,10-06-2024,4.2,-4.2,8546113.0,PCS,Issue to Patient,1.0,2.73993,-2.73993,494.0,1353.52657
6590020029,MAGNESIUM SULPHATE 50% INJ -5ML,Medicine,Rayan Hospital,RYN_IP,,,,1194926367,10-06-2024,4.2,-4.2,8546113.0,PCS,Issue to Patient,1.0,2.73993,-2.73993,493.0,1350.78664
6590020029,MAGNESIUM SULPHATE 50% INJ -5ML,Medicine,Rayan Hospital,STAGE,Rayan Hospital Clinics,RAY_ER,17654651,1194928537,10-06-2024,2.1,-4.2,854693.0,PCS,Int Order Direct Ship,2.0,2.73993,-5.47986,491.0,1345.30678
6590020029,MAGNESIUM SULPHATE 50% INJ -5ML,Medicine,Rayan Hospital,STAGE,Rayan Hospital Clinics,RAY_ER,17654651,1194928540,10-06-2024,2.1,-2.1,8546106.0,PCS,Int Order Direct Ship,1.0,2.73993,-2.73993,490.0,1342.56684
6590020029,MAGNESIUM SULPHATE 50% INJ -5ML,Medicine,Rayan Hospital,RYN_IP,,,,1195117160,10-06-2024,4.2,-8.4,8546113.0,PCS,Issue to Patient,2.0,2.81609,-5.63218,688.0,1937.47061
6590020029,MAGNESIUM SULPHATE 50% INJ -5ML,Medicine,Rayan Hospital,RYN_IP,,,,1195148141,10-06-2024,4.2,-67.2,8546113.0,PCS,Issue to Patient,16.0,2.81609,-45.05746,672.0,1892.41315
6590020029,MAGNESIUM SULPHATE 50% INJ -5ML,Medicine,Rayan Hospital,RYN_IP,,,,1195180442,10-06-2024,4.2,-16.8,8546113.0,PCS,Issue to Patient,4.0,2.81609,-11.26436,668.0,1881.14879
6590020029,MAGNESIUM SULPHATE 50% INJ -5ML,Medicine,Rayan Hospital,RYN_IP,,,,1195284802,11-06-2024,4.2,-4.2,8546113.0,PCS,Issue to Patient,1.0,2.81609,-2.81609,667.0,1878.3327
6590020029,MAGNESIUM SULPHATE 50% INJ -5ML,Medicine,Rayan Hospital,RYN_IP,,,,1195300898,11-06-2024,4.2,-8.4,8546113.0,PCS,Issue to Patient,2.0,2.81609,-5.63218,665.0,1872.70052
6590020029,MAGNESIUM SULPHATE 50% INJ -5ML,Medicine,Rayan Hospital,RYN_IP,,,,1195323696,11-06-2024,4.2,-8.4,8546113.0,PCS,Issue to Patient,2.0,2.81609,-5.63218,663.0,1867.06834
6590020029,MAGNESIUM SULPHATE 50% INJ -5ML,Medicine,Rayan Hospital,RYN_IP,,,,1195332857,11-06-2024,4.2,-16.8,8546113.0,PCS,Issue to Patient,4.0,2.81609,-11.26436,659.0,1855.80397
6590020029,MAGNESIUM SULPHATE 50% INJ -5ML,Medicine,Rayan Hospital,RYN_IP,,,,1195359155,11-06-2024,4.2,-4.2,8546113.0,PCS,Issue to Patient,1.0,2.81609,-2.81609,658.0,1852.98788
6590020029,MAGNESIUM SULPHATE 50% INJ -5ML,Medicine,Rayan Hospital,RYN_IP,,,,1195376935,11-06-2024,4.2,-4.2,8546113.0,PCS,Issue to Patient,1.0,2.81609,-2.81609,657.0,1850.17179
6590020029,MAGNESIUM SULPHATE 50% INJ -5ML,Medicine,Rayan Hospital,RYN_IP,,,,1195601746,11-06-2024,2.1,-2.1,8546106.0,PCS,Issue to Patient,1.0,2.81609,-2.81609,656.0,1847.3557
6590020029,MAGNESIUM SULPHATE 50% INJ -5ML,Medicine,Rayan Hospital,RYN_IP,,,,1195604400,11-06-2024,4.2,-4.2,8546113.0,PCS,Issue to Patient,1.0,2.81609,-2.81609,655.0,1844.53961
6590020029,MAGNESIUM SULPHATE 50% INJ -5ML,Medicine,Rayan Hospital,RYN_IP,,,,1195624876,11-06-2024,4.2,-8.4,8546113.0,PCS,Issue to Patient,2.0,2.81609,-5.63218,653.0,1838.90743
6590020029,MAGNESIUM SULPHATE 50% INJ -5ML,Medicine,Rayan Hospital,RYN_IP,,,,1195754410,11-06-2024,4.2,-4.2,8546113.0,PCS,Issue to Patient,1.0,2.81609,-2.81609,652.0,1836.09133
6590020029,MAGNESIUM SULPHATE 50% INJ -5ML,Medicine,Rayan Hospital,RYN_IP,,,,1195757268,11-06-2024,4.2,-16.8,8546113.0,PCS,Issue to Patient,4.0,2.81609,-11.26436,648.0,1824.82697
6590020029,MAGNESIUM SULPHATE 50% INJ -5ML,Medicine,Rayan Hospital,RYN_IP,,,,1195795493,11-06-2024,4.2,-4.2,8546113.0,PCS,Issue to Patient,1.0,2.81609,-2.81609,647.0,1822.01088
6590020029,MAGNESIUM SULPHATE 50% INJ -5ML,Medicine,Rayan Hospital,RYN_IP,,,,1195958801,11-06-2024,4.2,-8.4,8546113.0,PCS,Issue to Patient,2.0,2.81609,-5.63218,645.0,1816.3787
6590020029,MAGNESIUM SULPHATE 50% INJ -5ML,Medicine,Rayan Hospital,RYN_IP,,,,1196002571,12-06-2024,4.2,-8.4,8546113.0,PCS,Issue to Patient,2.0,2.81609,-5.63218,643.0,1810.74652
6590020029,MAGNESIUM SULPHATE 50% INJ -5ML,Medicine,Rayan Hospital,RYN_IP,,,,1196043988,12-06-2024,4.2,-4.2,8546113.0,PCS,Issue to Patient,1.0,2.81609,-2.81609,642.0,1807.93042
6590020029,MAGNESIUM SULPHATE 50% INJ -5ML,Medicine,Rayan Hospital,RYN_IP,,,,1196045928,12-06-2024,4.2,-8.4,8546113.0,PCS,Issue to Patient,2.0,2.81609,-5.63218,640.0,1802.29824
6590020029,MAGNESIUM SULPHATE 50% INJ -5ML,Medicine,Rayan Hospital,RYN_IP,,,,1196061946,12-06-2024,4.2,-8.4,8546113.0,PCS,Issue to Patient,2.0,2.81609,-5.63218,638.0,1796.66606
6590020029,MAGNESIUM SULPHATE 50% INJ -5ML,Medicine,Rayan Hospital,RYN_IP,,,,1196079685,12-06-2024,4.2,-8.4,8546113.0,PCS,Issue to Patient,2.0,2.81609,-5.63218,636.0,1791.03388
6590020029,MAGNESIUM SULPHATE 50% INJ -5ML,Medicine,Rayan Hospital,RYN_IP,,,,1196135845,12-06-2024,4.2,-8.4,8546113.0,PCS,Issue to Patient,2.0,2.81609,-5.63218,634.0,1785.4017
6590020029,MAGNESIUM SULPHATE 50% INJ -5ML,Medicine,Rayan Hospital,RYN_IP,,,,1196207228,12-06-2024,4.2,-16.8,8546113.0,PCS,Issue to Patient,4.0,2.81609,-11.26436,630.0,1774.13733
6590020029,MAGNESIUM SULPHATE 50% INJ -5ML,Medicine,Rayan Hospital,RYN_IP,,,,1196297884,12-06-2024,4.2,-4.2,8546113.0,PCS,Issue to Patient,1.0,2.81609,-2.81609,629.0,1771.32124
6590020029,MAGNESIUM SULPHATE 50% INJ -5ML,Medicine,Rayan Hospital,RYN_IP,,,,1196427477,12-06-2024,2.1,-2.1,8546106.0,PCS,Issue to Patient,1.0,2.81609,-2.81609,628.0,1768.50515
6590020029,MAGNESIUM SULPHATE 50% INJ -5ML,Medicine,Rayan Hospital,RYN_IP,,,,1196567697,12-06-2024,4.2,-16.8,8546113.0,PCS,Issue to Patient,4.0,2.81609,-11.26436,624.0,1757.24079
6590020029,MAGNESIUM SULPHATE 50% INJ -5ML,Medicine,Rayan Hospital,RYN_IP,,,,1196630054,13-06-2024,4.2,-8.4,8546113.0,PCS,Issue to Patient,2.0,2.81609,-5.63218,622.0,1751.6086
6590020029,MAGNESIUM SULPHATE 50% INJ -5ML,Medicine,Rayan Hospital,RYN_IP,,,,1196649791,13-06-2024,4.2,-16.8,8546113.0,PCS,Issue to Patient,4.0,2.81609,-11.26436,618.0,1740.34424
6590020029,MAGNESIUM SULPHATE 50% INJ -5ML,Medicine,Rayan Hospital,RYN_IP,,,,1196676430,13-06-2024,4.2,-4.2,8546113.0,PCS,Issue to Patient,1.0,2.81609,-2.81609,617.0,1737.52815
6590020029,MAGNESIUM SULPHATE 50% INJ -5ML,Medicine,Rayan Hospital,RYN_IP,,,,1196764629,13-06-2024,4.2,-8.4,8546113.0,PCS,Issue to Patient,2.0,2.81609,-5.63218,615.0,1731.89597
6590020029,MAGNESIUM SULPHATE 50% INJ -5ML,Medicine,Rayan Hospital,RYN_IP,,,,1196772219,13-06-2024,4.2,-16.8,8546113.0,PCS,Issue to Patient,4.0,2.81609,-11.26436,611.0,1720.6316
6590020029,MAGNESIUM SULPHATE 50% INJ -5ML,Medicine,Rayan Hospital,RYN_IP,,,,1196772224,13-06-2024,4.2,-8.4,8546113.0,PCS,Issue to Patient,2.0,2.81609,-5.63218,609.0,1714.99942
6590020029,MAGNESIUM SULPHATE 50% INJ -5ML,Medicine,Rayan Hospital,RYN_IP,,,,1196876787,13-06-2024,2.1,-2.1,8546103.0,PCS,Issue to Patient,1.0,2.81609,-2.81609,608.0,1712.18333
6590020029,MAGNESIUM SULPHATE 50% INJ -5ML,Medicine,Rayan Hospital,RYN_IP,,,,1196942322,13-06-2024,4.2,-16.8,8546113.0,PCS,Issue to Patient,4.0,2.81609,-11.26436,604.0,1700.91897
6590020029,MAGNESIUM SULPHATE 50% INJ -5ML,Medicine,Rayan Hospital,RYN_IP,,,,1197075169,13-06-2024,4.2,-16.8,8546113.0,PCS,Issue to Patient,4.0,2.81609,-11.26436,900.0,2534.4819
6590020029,MAGNESIUM SULPHATE 50% INJ -5ML,Medicine,Rayan Hospital,RYN_IP,,,,1197093092,13-06-2024,4.2,-8.4,8546113.0,PCS,Issue to Patient,2.0,2.81609,-5.63218,898.0,2528.84972
6590020029,MAGNESIUM SULPHATE 50% INJ -5ML,Medicine,Rayan Hospital,RYN_IP,,,,1197105843,13-06-2024,4.2,-16.8,8546113.0,PCS,Issue to Patient,4.0,2.81609,-11.26436,894.0,2517.58536
6590020029,MAGNESIUM SULPHATE 50% INJ -5ML,Medicine,Rayan Hospital,RYN_IP,,,,1197184189,14-06-2024,4.2,-8.4,8546113.0,PCS,Issue to Patient,2.0,2.81609,-5.63218,896.0,2523.21754
6590020029,MAGNESIUM SULPHATE 50% INJ -5ML,Medicine,Rayan Hospital,RYN_IP,,,,1197190425,14-06-2024,4.2,-16.8,8546113.0,PCS,Issue to Patient,4.0,2.81609,-11.26436,892.0,2511.95318
6590020029,MAGNESIUM SULPHATE 50% INJ -5ML,Medicine,Rayan Hospital,RYN_IP,,,,1197206914,14-06-2024,4.2,-16.8,8546113.0,PCS,Issue to Patient,4.0,2.81609,-11.26436,888.0,2500.68881
6590020029,MAGNESIUM SULPHATE 50% INJ -5ML,Medicine,Rayan Hospital,RYN_IP,,,,1197228081,14-06-2024,4.2,-4.2,8546113.0,PCS,Issue to Patient,1.0,2.81609,-2.81609,887.0,2497.87272
6590020029,MAGNESIUM SULPHATE 50% INJ -5ML,Medicine,Rayan Hospital,RYN_IP,,,,1197245670,14-06-2024,2.1,-2.1,8546106.0,PCS,Issue to Patient,1.0,2.81609,-2.81609,886.0,2495.05663
6590020029,MAGNESIUM SULPHATE 50% INJ -5ML,Medicine,Rayan Hospital,RYN_IP,,,,1197246051,14-06-2024,2.1,-2.1,8546106.0,PCS,Issue to Patient,1.0,2.81609,-2.81609,885.0,2492.24054
6590020029,MAGNESIUM SULPHATE 50% INJ -5ML,Medicine,Rayan Hospital,RYN_IP,,,,1197294200,14-06-2024,4.2,-16.8,8546113.0,PCS,Issue to Patient,4.0,2.81609,-11.26436,881.0,2480.97617
6590020029,MAGNESIUM SULPHATE 50% INJ -5ML,Medicine,Rayan Hospital,RYN_IP,,,,1197354490,14-06-2024,4.2,-4.2,8546113.0,PCS,Issue to Patient,1.0,2.81609,-2.81609,880.0,2478.16008
6590020029,MAGNESIUM SULPHATE 50% INJ -5ML,Medicine,Rayan Hospital,RYN_IP,,,,1197365497,14-06-2024,4.2,-16.8,8546113.0,PCS,Issue to Patient,4.0,2.81609,-11.26436,876.0,2466.89572
6590020029,MAGNESIUM SULPHATE 50% INJ -5ML,Medicine,Rayan Hospital,RYN_IP,,,,1197468737,15-06-2024,4.2,-8.4,8546113.0,PCS,Issue to Patient,2.0,2.81609,-5.63218,874.0,2461.26354
6590020029,MAGNESIUM SULPHATE 50% INJ -5ML,Medicine,Rayan Hospital,RYN_IP,,,,1197472618,15-06-2024,4.2,-8.4,8546113.0,PCS,Issue to Patient,2.0,2.81609,-5.63218,872.0,2455.63136
6590020029,MAGNESIUM SULPHATE 50% INJ -5ML,Medicine,Rayan Hospital,RYN_IP,,,,1197539979,15-06-2024,2.1,-2.1,8546106.0,PCS,Issue to Patient,1.0,2.81609,-2.81609,871.0,2452.81526
6590020029,MAGNESIUM SULPHATE 50% INJ -5ML,Medicine,Rayan Hospital,RYN_IP,,,,1197542168,15-06-2024,2.1,-2.1,8546104.0,PCS,Issue to Patient,1.0,2.81609,-2.81609,870.0,2449.99917
6590020029,MAGNESIUM SULPHATE 50% INJ -5ML,Medicine,Rayan Hospital,RYN_IP,,,,1197656240,16-06-2024,4.2,-8.4,8546113.0,PCS,Issue to Patient,2.0,2.81609,-5.63218,868.0,2444.36699
6590020029,MAGNESIUM SULPHATE 50% INJ -5ML,Medicine,Rayan Hospital,RYN_IP,,,,1197734165,16-06-2024,2.1,-2.1,8546106.0,PCS,Issue to Patient,1.0,2.81609,-2.81609,867.0,2441.5509
6590020029,MAGNESIUM SULPHATE 50% INJ -5ML,Medicine,Rayan Hospital,RYN_IP,,,,1197735688,16-06-2024,2.1,-2.1,8546104.0,PCS,Issue to Patient,1.0,2.81609,-2.81609,866.0,2438.73481
6590020029,MAGNESIUM SULPHATE 50% INJ -5ML,Medicine,Rayan Hospital,RYN_IP,,,,1197760314,16-06-2024,4.2,-8.4,8546113.0,PCS,Issue to Patient,2.0,2.81609,-5.63218,864.0,2433.10263
6590020029,MAGNESIUM SULPHATE 50% INJ -5ML,Medicine,Rayan Hospital,RYN_IP,,,,1197819449,17-06-2024,4.2,-4.2,8546113.0,PCS,Issue to Patient,1.0,2.81609,-2.81609,863.0,2430.28654
6590020029,MAGNESIUM SULPHATE 50% INJ -5ML,Medicine,Rayan Hospital,RYN_IP,,,,1197822996,17-06-2024,4.2,-4.2,8546113.0,PCS,Issue to Patient,1.0,2.81609,-2.81609,862.0,2427.47045
6590020029,MAGNESIUM SULPHATE 50% INJ -5ML,Medicine,Rayan Hospital,RYN_IP,,,,1197823001,17-06-2024,4.2,-4.2,8546113.0,PCS,Issue to Patient,1.0,2.81609,-2.81609,861.0,2424.65435
6590020029,MAGNESIUM SULPHATE 50% INJ -5ML,Medicine,Rayan Hospital,RYN_IP,,,,1197831060,17-06-2024,4.2,-8.4,8546113.0,PCS,Issue to Patient,2.0,2.81609,-5.63218,859.0,2419.02217
6590020029,MAGNESIUM SULPHATE 50% INJ -5ML,Medicine,Rayan Hospital,RYN_IP,,,,1197885743,17-06-2024,2.1,-2.1,8546104.0,PCS,Issue to Patient,1.0,2.81609,-2.81609,858.0,2416.20608
6590020029,MAGNESIUM SULPHATE 50% INJ -5ML,Medicine,Rayan Hospital,RYN_IP,,,,1197936672,17-06-2024,4.2,-4.2,8546113.0,PCS,Issue to Patient,1.0,2.81609,-2.81609,857.0,2413.38999
6590020029,MAGNESIUM SULPHATE 50% INJ -5ML,Medicine,Rayan Hospital,RYN_IP,,,,1197965583,17-06-2024,4.2,-8.4,8546113.0,PCS,Issue to Patient,2.0,2.81609,-5.63218,855.0,2407.75781
6590020029,MAGNESIUM SULPHATE 50% INJ -5ML,Medicine,Rayan Hospital,RYN_IP,,,,1197981097,17-06-2024,4.2,-8.4,8546113.0,PCS,Issue to Patient,2.0,2.81609,-5.63218,853.0,2402.12563
6590020029,MAGNESIUM SULPHATE 50% INJ -5ML,Medicine,Rayan Hospital,RYN_IP,,,,1197994079,18-06-2024,4.2,-4.2,8546113.0,PCS,Issue to Patient,1.0,2.81609,-2.81609,852.0,2399.30954
6590020029,MAGNESIUM SULPHATE 50% INJ -5ML,Medicine,Rayan Hospital,RYN_IP,,,,1198023804,18-06-2024,4.2,-4.2,8546113.0,PCS,Issue to Patient,1.0,2.81609,-2.81609,851.0,2396.49344
6590020029,MAGNESIUM SULPHATE 50% INJ -5ML,Medicine,Rayan Hospital,RYN_IP,,,,1198024118,18-06-2024,4.2,-8.4,8546113.0,PCS,Issue to Patient,2.0,2.81609,-5.63218,849.0,2390.86126
6590020029,MAGNESIUM SULPHATE 50% INJ -5ML,Medicine,Rayan Hospital,RYN_IP,,,,1198026137,18-06-2024,4.2,-8.4,8546113.0,PCS,Issue to Patient,2.0,2.81609,-5.63218,847.0,2385.22908
6590020029,MAGNESIUM SULPHATE 50% INJ -5ML,Medicine,Rayan Hospital,RYN_IP,,,,1198026147,18-06-2024,4.2,-12.6,8546113.0,PCS,Issue to Patient,3.0,2.81609,-8.44827,844.0,2376.78081
6590020029,MAGNESIUM SULPHATE 50% INJ -5ML,Medicine,Rayan Hospital,RYN_IP,,,,1198026157,18-06-2024,4.2,-16.8,8546113.0,PCS,Issue to Patient,4.0,2.81609,-11.26436,840.0,2365.51644
6590020029,MAGNESIUM SULPHATE 50% INJ -5ML,Medicine,Rayan Hospital,RYN_IP,,,,1198040390,18-06-2024,4.2,-4.2,8546113.0,PCS,Issue to Patient,1.0,2.81609,-2.81609,839.0,2362.70035
6590020029,MAGNESIUM SULPHATE 50% INJ -5ML,Medicine,Rayan Hospital,RYN_IP,,,,1198199648,19-06-2024,4.2,-4.2,8546113.0,PCS,Issue to Patient,1.0,2.81609,-2.81609,838.0,2359.88426
6590020029,MAGNESIUM SULPHATE 50% INJ -5ML,Medicine,Rayan Hospital,RYN_IP,,,,1198242170,19-06-2024,4.2,-8.4,8546113.0,PCS,Issue to Patient,2.0,2.81609,-5.63218,836.0,2354.25208
6590020029,MAGNESIUM SULPHATE 50% INJ -5ML,Medicine,Rayan Hospital,RYN_IP,,,,1198242185,19-06-2024,4.2,-16.8,8546113.0,PCS,Issue to Patient,4.0,2.81609,-11.26436,832.0,2342.98772
6590020029,MAGNESIUM SULPHATE 50% INJ -5ML,Medicine,Rayan Hospital,RYN_IP,,,,1198325859,19-06-2024,2.1,-6.3,8546104.0,PCS,Issue to Patient,3.0,2.81609,-8.44827,829.0,2334.53944
6590020029,MAGNESIUM SULPHATE 50% INJ -5ML,Medicine,Rayan Hospital,RYN_IP,,,,1198470929,19-06-2024,2.1,-2.1,8546104.0,PCS,Issue to Patient,1.0,2.81609,-2.81609,828.0,2331.72335
6590020029,MAGNESIUM SULPHATE 50% INJ -5ML,Medicine,Rayan Hospital,RYN_IP,,,,1198471842,19-06-2024,2.1,-2.1,8546104.0,PCS,Issue to Patient,1.0,2.81609,-2.81609,827.0,2328.90726
6590020029,MAGNESIUM SULPHATE 50% INJ -5ML,Medicine,Rayan Hospital,RYN_IP,,,,1198478962,19-06-2024,4.2,-16.8,8546113.0,PCS,Issue to Patient,4.0,2.81609,-11.26436,823.0,2317.6429
6590020029,MAGNESIUM SULPHATE 50% INJ -5ML,Medicine,Rayan Hospital,RYN_IP,,,,1198602762,19-06-2024,4.2,-16.8,8546113.0,PCS,Issue to Patient,4.0,2.81609,-11.26436,819.0,2306.37853
6590020029,MAGNESIUM SULPHATE 50% INJ -5ML,Medicine,Rayan Hospital,RYN_IP,,,,1198621821,20-06-2024,4.2,-4.2,8546113.0,PCS,Issue to Patient,1.0,2.81609,-2.81609,818.0,2303.56244
6590020029,MAGNESIUM SULPHATE 50% INJ -5ML,Medicine,Rayan Hospital,RYN_IP,,,,1198830261,20-06-2024,4.2,-4.2,8546113.0,PCS,Issue to Patient,1.0,2.81609,-2.81609,817.0,2300.74635
6590020029,MAGNESIUM SULPHATE 50% INJ -5ML,Medicine,Rayan Hospital,RYN_IP,,,,1198929625,20-06-2024,2.1,-2.1,8546104.0,PCS,Issue to Patient,1.0,2.81609,-2.81609,816.0,2297.93026
6590020029,MAGNESIUM SULPHATE 50% INJ -5ML,Medicine,Rayan Hospital,RYN_IP,,,,1198971581,20-06-2024,4.2,-16.8,8546113.0,PCS,Issue to Patient,4.0,2.81609,-11.26436,812.0,2286.6659
6590020029,MAGNESIUM SULPHATE 50% INJ -5ML,Medicine,Rayan Hospital,RYN_IP,,,,1198973789,20-06-2024,4.2,-8.4,8546113.0,PCS,Issue to Patient,2.0,2.81609,-5.63218,810.0,2281.03371
6590020029,MAGNESIUM SULPHATE 50% INJ -5ML,Medicine,Rayan Hospital,RYN_IP,,,,1199059889,20-06-2024,4.2,-16.8,8546113.0,PCS,Issue to Patient,4.0,2.81609,-11.26436,806.0,2269.76935
6590020029,MAGNESIUM SULPHATE 50% INJ -5ML,Medicine,Rayan Hospital,RYN_IP,,,,1199277510,21-06-2024,4.2,-4.2,8546113.0,PCS,Issue to Patient,1.0,2.81609,-2.81609,805.0,2266.95326
6590020029,MAGNESIUM SULPHATE 50% INJ -5ML,Medicine,Rayan Hospital,RYN_IP,,,,1199278514,21-06-2024,4.2,-16.8,8546113.0,PCS,Issue to Patient,4.0,2.81609,-11.26436,801.0,2255.68889
6590020029,MAGNESIUM SULPHATE 50% INJ -5ML,Medicine,Rayan Hospital,RYN_IP,,,,1199290932,21-06-2024,2.1,-2.1,8546104.0,PCS,Issue to Patient,1.0,2.81609,-2.81609,800.0,2252.8728
6590020029,MAGNESIUM SULPHATE 50% INJ -5ML,Medicine,Rayan Hospital,RYN_IP,,,,1199293723,21-06-2024,4.2,-8.4,8546113.0,PCS,Issue to Patient,2.0,2.81609,-5.63218,798.0,2247.24062
6590020029,MAGNESIUM SULPHATE 50% INJ -5ML,Medicine,Rayan Hospital,RYN_IP,,,,1199484493,22-06-2024,4.2,-4.2,8546113.0,PCS,Issue to Patient,1.0,2.81609,-2.81609,797.0,2244.42453
6590020029,MAGNESIUM SULPHATE 50% INJ -5ML,Medicine,Rayan Hospital,RYN_IP,,,,1199509042,22-06-2024,4.2,-8.4,8546113.0,PCS,Issue to Patient,2.0,2.81609,-5.63218,795.0,2238.79235
6590020029,MAGNESIUM SULPHATE 50% INJ -5ML,Medicine,Rayan Hospital,RYN_IP,,,,1199515657,22-06-2024,4.2,-8.4,8546113.0,PCS,Issue to Patient,2.0,2.81609,-5.63218,793.0,2233.16017
6590020029,MAGNESIUM SULPHATE 50% INJ -5ML,Medicine,Rayan Hospital,RYN_IP,,,,1199519363,22-06-2024,4.2,-8.4,8546113.0,PCS,Issue to Patient,2.0,2.81609,-5.63218,791.0,2227.52798
6590020029,MAGNESIUM SULPHATE 50% INJ -5ML,Medicine,Rayan Hospital,RYN_IP,,,,1199538654,22-06-2024,4.2,-4.2,8546113.0,PCS,Issue to Patient,1.0,2.81609,-2.81609,790.0,2224.71189
6590020029,MAGNESIUM SULPHATE 50% INJ -5ML,Medicine,Rayan Hospital,RYN_IP,,,,1199618994,22-06-2024,2.1,-2.1,8546104.0,PCS,Issue to Patient,1.0,2.81609,-2.81609,789.0,2221.8958
6590020029,MAGNESIUM SULPHATE 50% INJ -5ML,Medicine,Rayan Hospital,RYN_IP,,,,1199624213,22-06-2024,2.1,-2.1,8546104.0,PCS,Issue to Patient,1.0,2.81609,-2.81609,788.0,2219.07971
6590020029,MAGNESIUM SULPHATE 50% INJ -5ML,Medicine,Rayan Hospital,RYN_IP,,,,1199627710,22-06-2024,2.1,-2.1,8546104.0,PCS,Issue to Patient,1.0,2.81609,-2.81609,787.0,2216.26362
6590020029,MAGNESIUM SULPHATE 50% INJ -5ML,Medicine,Rayan Hospital,RYN_IP,,,,1199876669,22-06-2024,4.2,-8.4,8546113.0,PCS,Issue to Patient,2.0,2.81609,-5.63218,785.0,2210.63144
6590020029,MAGNESIUM SULPHATE 50% INJ -5ML,Medicine,Rayan Hospital,RYN_IP,,,,1200010367,23-06-2024,4.2,-8.4,8546113.0,PCS,Issue to Patient,2.0,2.81609,-5.63218,783.0,2204.99926
6590020029,MAGNESIUM SULPHATE 50% INJ -5ML,Medicine,Rayan Hospital,RYN_IP,,,,1200010397,23-06-2024,4.2,-4.2,8546113.0,PCS,Issue to Patient,1.0,2.81609,-2.81609,782.0,2202.18317
6590020029,MAGNESIUM SULPHATE 50% INJ -5ML,Medicine,Rayan Hospital,RYN_IP,,,,1200010880,23-06-2024,4.2,-8.4,8546113.0,PCS,Issue to Patient,2.0,2.81609,-5.63218,780.0,2196.55098
6590020029,MAGNESIUM SULPHATE 50% INJ -5ML,Medicine,Rayan Hospital,RYN_IP,,,,1200015695,23-06-2024,4.2,-16.8,8546113.0,PCS,Issue to Patient,4.0,2.81609,-11.26436,776.0,2185.28662
6590020029,MAGNESIUM SULPHATE 50% INJ -5ML,Medicine,Rayan Hospital,RYN_IP,,,,1200016074,23-06-2024,4.2,-8.4,8546113.0,PCS,Issue to Patient,2.0,2.81609,-5.63218,774.0,2179.65444
6590020029,MAGNESIUM SULPHATE 50% INJ -5ML,Medicine,Rayan Hospital,RYN_IP,,,,1200022204,23-06-2024,4.2,-8.4,8546113.0,PCS,Issue to Patient,2.0,2.81609,-5.63218,772.0,2174.02226
6590020029,MAGNESIUM SULPHATE 50% INJ -5ML,Medicine,Rayan Hospital,RYN_IP,,,,1200121726,23-06-2024,4.2,-8.4,8546113.0,PCS,Issue to Patient,2.0,2.81609,-5.63218,770.0,2168.39007
6590020029,MAGNESIUM SULPHATE 50% INJ -5ML,Medicine,Rayan Hospital,RYN_IP,,,,1200149620,23-06-2024,4.2,-8.4,8546113.0,PCS,Issue to Patient,2.0,2.81609,-5.63218,768.0,2162.75789
6590020029,MAGNESIUM SULPHATE 50% INJ -5ML,Medicine,Rayan Hospital,RYN_IP,,,,1200149645,23-06-2024,4.2,-16.8,8546113.0,PCS,Issue to Patient,4.0,2.81609,-11.26436,764.0,2151.49353
6590020029,MAGNESIUM SULPHATE 50% INJ -5ML,Medicine,Rayan Hospital,RYN_IP,,,,1200200720,23-06-2024,4.2,-4.2,8546113.0,PCS,Issue to Patient,1.0,2.81609,-2.81609,763.0,2148.67744
6590020029,MAGNESIUM SULPHATE 50% INJ -5ML,Medicine,Rayan Hospital,RYN_IP,,,,1200236520,23-06-2024,2.1,-2.1,8546104.0,PCS,Issue to Patient,1.0,2.81609,-2.81609,762.0,2145.86134
6590020029,MAGNESIUM SULPHATE 50% INJ -5ML,Medicine,Rayan Hospital,RYN_IP,,,,1200239281,23-06-2024,4.2,-4.2,8546113.0,PCS,Issue to Patient,1.0,2.81609,-2.81609,761.0,2143.04525
6590020029,MAGNESIUM SULPHATE 50% INJ -5ML,Medicine,Rayan Hospital,RYN_IP,,,,1200243306,23-06-2024,2.1,-2.1,8546106.0,PCS,Issue to Patient,1.0,2.81609,-2.81609,760.0,2140.22916
6590020029,MAGNESIUM SULPHATE 50% INJ -5ML,Medicine,Rayan Hospital,RYN_IP,,,,1200254281,23-06-2024,2.1,-2.1,8546104.0,PCS,Issue to Patient,1.0,2.81609,-2.81609,759.0,2137.41307
6590020029,MAGNESIUM SULPHATE 50% INJ -5ML,Medicine,Rayan Hospital,RYN_IP,,,,1200516075,23-06-2024,4.2,-42.0,8546113.0,PCS,Issue to Patient,10.0,2.81609,-28.16091,749.0,2109.25216
6590020029,MAGNESIUM SULPHATE 50% INJ -5ML,Medicine,Rayan Hospital,RYN_IP,,,,1200524514,23-06-2024,4.2,-8.4,8546113.0,PCS,Issue to Patient,2.0,2.81609,-5.63218,747.0,2103.61998
6590020029,MAGNESIUM SULPHATE 50% INJ -5ML,Medicine,Rayan Hospital,RYN_IP,,,,1200534670,23-06-2024,4.2,-8.4,8546113.0,PCS,Issue to Patient,2.0,2.81609,-5.63218,745.0,2097.9878
6590020029,MAGNESIUM SULPHATE 50% INJ -5ML,Medicine,Rayan Hospital,RYN_IP,,,,1200540165,23-06-2024,4.2,-8.4,8546113.0,PCS,Issue to Patient,2.0,2.81609,-5.63218,743.0,2092.35562
6590020029,MAGNESIUM SULPHATE 50% INJ -5ML,Medicine,Rayan Hospital,RYN_IP,,,,1200585457,24-06-2024,4.2,-4.2,8546113.0,PCS,Issue to Patient,1.0,2.81609,-2.81609,742.0,2089.53952
6590020029,MAGNESIUM SULPHATE 50% INJ -5ML,Medicine,Rayan Hospital,RYN_IP,,,,1200600802,24-06-2024,4.2,-8.4,8546113.0,PCS,Issue to Patient,2.0,2.81609,-5.63218,740.0,2083.90734
6590020029,MAGNESIUM SULPHATE 50% INJ -5ML,Medicine,Rayan Hospital,RYN_IP,,,,1200616163,24-06-2024,4.2,-8.4,8546113.0,PCS,Issue to Patient,2.0,2.81609,-5.63218,738.0,2078.27516
6590020029,MAGNESIUM SULPHATE 50% INJ -5ML,Medicine,Rayan Hospital,RYN_IP,,,,1200658857,24-06-2024,4.2,-4.2,8546113.0,PCS,Issue to Patient,1.0,2.81609,-2.81609,737.0,2075.45907
6590020029,MAGNESIUM SULPHATE 50% INJ -5ML,Medicine,Rayan Hospital,RYN_IP,,,,1200784420,24-06-2024,4.2,-16.8,8546113.0,PCS,Issue to Patient,4.0,2.81609,-11.26436,733.0,2064.19471
6590020029,MAGNESIUM SULPHATE 50% INJ -5ML,Medicine,Rayan Hospital,RYN_IP,,,,1200849284,24-06-2024,4.2,-4.2,8546113.0,PCS,Issue to Patient,1.0,2.81609,-2.81609,732.0,2061.37861
6590020029,MAGNESIUM SULPHATE 50% INJ -5ML,Medicine,Rayan Hospital,RYN_IP,,,,1200855360,24-06-2024,4.2,-4.2,8546113.0,PCS,Issue to Patient,1.0,2.81609,-2.81609,731.0,2058.56252
6590020029,MAGNESIUM SULPHATE 50% INJ -5ML,Medicine,Rayan Hospital,RYN_IP,,,,1201043082,24-06-2024,4.2,-8.4,8546113.0,PCS,Issue to Patient,2.0,2.81609,-5.63218,729.0,2052.93034
6590020029,MAGNESIUM SULPHATE 50% INJ -5ML,Medicine,Rayan Hospital,RYN_IP,,,,1201175526,25-06-2024,4.2,-4.2,8546113.0,PCS,Issue to Patient,1.0,2.81609,-2.81609,728.0,2050.11425
6590020029,MAGNESIUM SULPHATE 50% INJ -5ML,Medicine,Rayan Hospital,RYN_IP,,,,1201558406,25-06-2024,2.1,-2.1,8546104.0,PCS,Issue to Patient,1.0,2.81609,-2.81609,727.0,2047.29816
6590020029,MAGNESIUM SULPHATE 50% INJ -5ML,Medicine,Rayan Hospital,RYN_IP,,,,1201558411,25-06-2024,2.1,-2.1,8546104.0,PCS,Issue to Patient,1.0,2.81609,-2.81609,726.0,2044.48207
6590020029,MAGNESIUM SULPHATE 50% INJ -5ML,Medicine,Rayan Hospital,RYN_IP,,,,1201614556,25-06-2024,4.2,-8.4,8546113.0,PCS,Issue to Patient,2.0,2.81609,-5.63218,724.0,2038.84989
6590020029,MAGNESIUM SULPHATE 50% INJ -5ML,Medicine,Rayan Hospital,RYN_IP,,,,1201723337,26-06-2024,4.2,-8.4,8546113.0,PCS,Issue to Patient,2.0,2.81609,-5.63218,722.0,2033.2177
6590020029,MAGNESIUM SULPHATE 50% INJ -5ML,Medicine,Rayan Hospital,RYN_IP,,,,1201739162,26-06-2024,4.2,-16.8,8546113.0,PCS,Issue to Patient,4.0,2.81609,-11.26436,718.0,2021.95334
6590020029,MAGNESIUM SULPHATE 50% INJ -5ML,Medicine,Rayan Hospital,RYN_IP,,,,1201744985,26-06-2024,4.2,-4.2,8546113.0,PCS,Issue to Patient,1.0,2.81609,-2.81609,717.0,2019.13725
6590020029,MAGNESIUM SULPHATE 50% INJ -5ML,Medicine,Rayan Hospital,RYN_IP,,,,1201770063,26-06-2024,4.2,-8.4,8546113.0,PCS,Issue to Patient,2.0,2.81609,-5.63218,715.0,2013.50507
6590020029,MAGNESIUM SULPHATE 50% INJ -5ML,Medicine,Rayan Hospital,RYN_IP,,,,1201818460,26-06-2024,4.2,-16.8,8546113.0,PCS,Issue to Patient,4.0,2.81609,-11.26436,711.0,2002.2407
6590020029,MAGNESIUM SULPHATE 50% INJ -5ML,Medicine,Rayan Hospital,RYN_IP,,,,1201847281,26-06-2024,4.2,-8.4,8546113.0,PCS,Issue to Patient,2.0,2.81609,-5.63218,709.0,1996.60852
6590020029,MAGNESIUM SULPHATE 50% INJ -5ML,Medicine,Rayan Hospital,RYN_IP,,,,1201896950,26-06-2024,4.2,-16.8,8546113.0,PCS,Issue to Patient,4.0,2.81609,-11.26436,705.0,1985.34416
6590020029,MAGNESIUM SULPHATE 50% INJ -5ML,Medicine,Rayan Hospital,RYN_IP,,,,1201936691,26-06-2024,2.1,-2.1,8546106.0,PCS,Issue to Patient,1.0,2.81609,-2.81609,704.0,1982.52807
6590020029,MAGNESIUM SULPHATE 50% INJ -5ML,Medicine,Rayan Hospital,RYN_IP,,,,1201936696,26-06-2024,2.1,-2.1,8546106.0,PCS,Issue to Patient,1.0,2.81609,-2.81609,703.0,1979.71198
6590020029,MAGNESIUM SULPHATE 50% INJ -5ML,Medicine,Rayan Hospital,RYN_IP,,,,1202017247,26-06-2024,4.2,-8.4,8546113.0,PCS,Issue to Patient,2.0,2.81609,-5.63218,701.0,1974.07979
6590020029,MAGNESIUM SULPHATE 50% INJ -5ML,Medicine,Rayan Hospital,RYN_IP,,,,1202220985,26-06-2024,4.2,-16.8,8546113.0,PCS,Issue to Patient,4.0,2.81609,-11.26436,697.0,1962.81543
6590020029,MAGNESIUM SULPHATE 50% INJ -5ML,Medicine,Rayan Hospital,RYN_IP,,,,1202273888,26-06-2024,4.2,-8.4,8546113.0,PCS,Issue to Patient,2.0,2.81609,-5.63218,695.0,1957.18325
6590020029,MAGNESIUM SULPHATE 50% INJ -5ML,Medicine,Rayan Hospital,RYN_IP,,,,1202301990,26-06-2024,4.2,-16.8,8546113.0,PCS,Issue to Patient,4.0,2.81609,-11.26436,691.0,1945.91888
6590020029,MAGNESIUM SULPHATE 50% INJ -5ML,Medicine,Rayan Hospital,RYN_IP,,,,1202344028,27-06-2024,4.2,-8.4,8546113.0,PCS,Issue to Patient,2.0,2.81609,-5.63218,689.0,1940.2867
6590020029,MAGNESIUM SULPHATE 50% INJ -5ML,Medicine,Rayan Hospital,RYN_IP,,,,1202362433,27-06-2024,4.2,-16.8,8546113.0,PCS,Issue to Patient,4.0,2.81609,-11.26436,685.0,1929.02234
6590020029,MAGNESIUM SULPHATE 50% INJ -5ML,Medicine,Rayan Hospital,RYN_IP,,,,1202364513,27-06-2024,4.2,-8.4,8546113.0,PCS,Issue to Patient,2.0,2.81609,-5.63218,683.0,1923.39016
6590020029,MAGNESIUM SULPHATE 50% INJ -5ML,Medicine,Rayan Hospital,RYN_IP,,,,1202365069,27-06-2024,4.2,-8.4,8546113.0,PCS,Issue to Patient,2.0,2.81609,-5.63218,681.0,1917.75797
6590020029,MAGNESIUM SULPHATE 50% INJ -5ML,Medicine,Rayan Hospital,RYN_IP,,,,1202365519,27-06-2024,4.2,-8.4,8546113.0,PCS,Issue to Patient,2.0,2.81609,-5.63218,679.0,1912.12579
6590020029,MAGNESIUM SULPHATE 50% INJ -5ML,Medicine,Rayan Hospital,RYN_IP,,,,1202371198,27-06-2024,4.2,-8.4,8546113.0,PCS,Issue to Patient,2.0,2.81609,-5.63218,677.0,1906.49361
6590020029,MAGNESIUM SULPHATE 50% INJ -5ML,Medicine,Rayan Hospital,RYN_IP,,,,1202371203,27-06-2024,4.2,-8.4,8546113.0,PCS,Issue to Patient,2.0,2.81609,-5.63218,675.0,1900.86143
6590020029,MAGNESIUM SULPHATE 50% INJ -5ML,Medicine,Rayan Hospital,RYN_IP,,,,1202425341,27-06-2024,4.2,-4.2,8546113.0,PCS,Issue to Patient,1.0,2.81609,-2.81609,674.0,1898.04534
6590020029,MAGNESIUM SULPHATE 50% INJ -5ML,Medicine,Rayan Hospital,RYN_IP,,,,1202635321,27-06-2024,4.2,-8.4,8546113.0,PCS,Issue to Patient,2.0,2.81609,-5.63218,672.0,1892.41315
6590020029,MAGNESIUM SULPHATE 50% INJ -5ML,Medicine,Rayan Hospital,RYN_IP,,,,1202652545,27-06-2024,4.2,-16.8,8546113.0,PCS,Issue to Patient,4.0,2.81609,-11.26436,668.0,1881.14879
6590020029,MAGNESIUM SULPHATE 50% INJ -5ML,Medicine,Rayan Hospital,RYN_IP,,,,1202679684,27-06-2024,2.1,-2.1,8546106.0,PCS,Issue to Patient,1.0,2.81609,-2.81609,667.0,1878.3327
6590020029,MAGNESIUM SULPHATE 50% INJ -5ML,Medicine,Rayan Hospital,RYN_IP,,,,1202679959,27-06-2024,2.1,-2.1,8546106.0,PCS,Issue to Patient,1.0,2.81609,-2.81609,666.0,1875.51661
6590020029,MAGNESIUM SULPHATE 50% INJ -5ML,Medicine,Rayan Hospital,RYN_IP,,,,1202899026,28-06-2024,4.2,-4.2,8546113.0,PCS,Issue to Patient,1.0,2.81609,-2.81609,665.0,1872.70052
6590020029,MAGNESIUM SULPHATE 50% INJ -5ML,Medicine,Rayan Hospital,RYN_IP,,,,1202903319,28-06-2024,4.2,-8.4,8546113.0,PCS,Issue to Patient,2.0,2.81609,-5.63218,663.0,1867.06834
6590020029,MAGNESIUM SULPHATE 50% INJ -5ML,Medicine,Rayan Hospital,RYN_IP,,,,1202904651,28-06-2024,4.2,-4.2,8546113.0,PCS,Issue to Patient,1.0,2.81609,-2.81609,662.0,1864.25224
6590020029,MAGNESIUM SULPHATE 50% INJ -5ML,Medicine,Rayan Hospital,RYN_IP,,,,1202921641,28-06-2024,4.2,-8.4,8546113.0,PCS,Issue to Patient,2.0,2.81609,-5.63218,660.0,1858.62006
6590020029,MAGNESIUM SULPHATE 50% INJ -5ML,Medicine,Rayan Hospital,RYN_IP,,,,1202973344,28-06-2024,4.2,-4.2,8546113.0,PCS,Issue to Patient,1.0,2.81609,-2.81609,659.0,1855.80397
6590020029,MAGNESIUM SULPHATE 50% INJ -5ML,Medicine,Rayan Hospital,RYN_IP,,,,1202975971,28-06-2024,2.1,-2.1,8546106.0,PCS,Issue to Patient,1.0,2.81609,-2.81609,658.0,1852.98788
6590020029,MAGNESIUM SULPHATE 50% INJ -5ML,Medicine,Rayan Hospital,RYN_IP,,,,1202976587,28-06-2024,2.1,-2.1,8546106.0,PCS,Issue to Patient,1.0,2.81609,-2.81609,657.0,1850.17179
6590020029,MAGNESIUM SULPHATE 50% INJ -5ML,Medicine,Rayan Hospital,RYN_IP,,,,1203135281,29-06-2024,4.2,-8.4,8546113.0,PCS,Issue to Patient,2.0,2.81609,-5.63218,655.0,1844.53961
6590020029,MAGNESIUM SULPHATE 50% INJ -5ML,Medicine,Rayan Hospital,RYN_IP,,,,1203135897,29-06-2024,4.2,-4.2,8546113.0,PCS,Issue to Patient,1.0,2.81609,-2.81609,654.0,1841.72352
6590020029,MAGNESIUM SULPHATE 50% INJ -5ML,Medicine,Rayan Hospital,RYN_IP,,,,1203136402,29-06-2024,4.2,-8.4,8546113.0,PCS,Issue to Patient,2.0,2.81609,-5.63218,652.0,1836.09133
6590020029,MAGNESIUM SULPHATE 50% INJ -5ML,Medicine,Rayan Hospital,RYN_IP,,,,1203289039,29-06-2024,4.2,-8.4,8546113.0,PCS,Issue to Patient,2.0,2.81609,-5.63218,650.0,1830.45915
6590020029,MAGNESIUM SULPHATE 50% INJ -5ML,Medicine,Rayan Hospital,RYN_IP,,,,1203300780,29-06-2024,4.2,-4.2,8546113.0,PCS,Issue to Patient,1.0,2.81609,-2.81609,649.0,1827.64306
6590020029,MAGNESIUM SULPHATE 50% INJ -5ML,Medicine,Rayan Hospital,RYN_IP,,,,1203658855,30-06-2024,4.2,-8.4,8546113.0,PCS,Issue to Patient,2.0,2.81609,-5.63218,647.0,1822.01088
6590020029,MAGNESIUM SULPHATE 50% INJ -5ML,Medicine,Rayan Hospital,RYN_IP,,,,1203660892,30-06-2024,4.2,-16.8,8546113.0,PCS,Issue to Patient,4.0,2.81609,-11.26436,643.0,1810.74652
6590020029,MAGNESIUM SULPHATE 50% INJ -5ML,Medicine,Rayan Hospital,RYN_IP,,,,1203664527,30-06-2024,4.2,-8.4,8546113.0,PCS,Issue to Patient,2.0,2.81609,-5.63218,641.0,1805.11433
6590020029,MAGNESIUM SULPHATE 50% INJ -5ML,Medicine,Rayan Hospital,RYN_IP,,,,1203683092,30-06-2024,4.2,-8.4,8546113.0,PCS,Issue to Patient,2.0,2.81609,-5.63218,639.0,1799.48215
6590020029,MAGNESIUM SULPHATE 50% INJ -5ML,Medicine,Rayan Hospital,RYN_IP,,,,1203758976,30-06-2024,4.2,-8.4,8546113.0,PCS,Issue to Patient,2.0,2.81609,-5.63218,637.0,1793.84997
6590020029,MAGNESIUM SULPHATE 50% INJ -5ML,Medicine,Rayan Hospital,RYN_IP,,,,1203888153,30-06-2024,4.2,-4.2,8546113.0,PCS,Issue to Patient,1.0,2.81609,-2.81609,636.0,1791.03388
6590020029,MAGNESIUM SULPHATE 50% INJ -5ML,Medicine,Rayan Hospital,RYN_IP,,,,1203888609,30-06-2024,2.1,-2.1,8546104.0,PCS,Issue to Patient,1.0,2.81609,-2.81609,635.0,1788.21779
6590020029,MAGNESIUM SULPHATE 50% INJ -5ML,Medicine,Rayan Hospital,RYN_IP,,,,1203921375,30-06-2024,4.2,-8.4,8546113.0,PCS,Issue to Patient,2.0,2.81609,-5.63218,633.0,1782.58561
6590020029,MAGNESIUM SULPHATE 50% INJ -5ML,Medicine,Rayan Hospital,RYN_IP,,,,1203926599,30-06-2024,2.1,-2.1,8546106.0,PCS,Issue to Patient,1.0,2.81609,-2.81609,632.0,1779.76951
6590020029,MAGNESIUM SULPHATE 50% INJ -5ML,Medicine,Rayan Hospital,RYN_IP,,,,1203928077,30-06-2024,4.2,-16.8,8546113.0,PCS,Issue to Patient,4.0,2.81609,-11.26436,628.0,1768.50515
6590020029,MAGNESIUM SULPHATE 50% INJ -5ML,Medicine,Rayan Hospital,RYN_IP,,,,1203932264,30-06-2024,4.2,-16.8,8546113.0,PCS,Issue to Patient,4.0,2.81609,-11.26436,626.0,1762.87297
6590020029,MAGNESIUM SULPHATE 50% INJ -5ML,Medicine,Rayan Hospital,RYN_IP,,,,1203935456,30-06-2024,2.1,-2.1,8546106.0,PCS,Issue to Patient,1.0,2.81609,-2.81609,629.0,1771.32124
6590020029,MAGNESIUM SULPHATE 50% INJ -5ML,Medicine,Rayan Hospital,RYN_IP,,,,1204129941,30-06-2024,4.2,-16.8,8546113.0,PCS,Issue to Patient,4.0,2.81609,-11.26436,625.0,1760.05688
6590020029,MAGNESIUM SULPHATE 50% INJ -5ML,Medicine,Rayan Hospital,RYN_IP,,,,1204137056,30-06-2024,4.2,-8.4,8546113.0,PCS,Issue to Patient,2.0,2.81609,-5.63218,623.0,1754.4247
6590020029,MAGNESIUM SULPHATE 50% INJ -5ML,Medicine,Rayan Hospital,RYN_IP,,,,1204190046,30-06-2024,4.2,-16.8,8546113.0,PCS,Issue to Patient,4.0,2.81609,-11.26436,619.0,1743.16033
6590020029,MAGNESIUM SULPHATE 50% INJ -5ML,Medicine,Rayan Hospital,RYN_IP,,,,1204272487,30-06-2024,4.2,-16.8,8546113.0,PCS,Issue to Patient,4.0,2.81609,-11.26436,615.0,1731.89597
